name,value,year_value,full_year,year,lastValue,rank,games_home,games_away,score_home,score_away,win_home,win_away,loss_home,loss_away,draw_home,draw_away
Wales,1,1,1879,1870.9,0,1,1,1,0,1,0,0,1,1,0,0
Wales,4,3,1880,1880,1,1,1,1,2,1,0,0,1,1,0,0
Wales,6,2,1881,1880.1,4,1,1,1,1,1,0,1,1,0,0,0
Wales,18,12,1882,1880.2,6,1,2,1,12,0,2,0,0,1,0,0
Northern Ireland,1,1,1882,1880.2,0,2,1,1,0,1,0,0,1,1,0,0
Wales,19,1,1883,1880.3,18,1,1,2,0,1,0,0,1,1,0,1
Northern Ireland,2,1,1883,1880.3,1,2,1,1,1,0,0,0,0,1,1,0
Wales,26,7,1884,1880.4,19,1,2,1,6,1,1,0,1,1,0,0
Scotland,10,10,1884,1880.4,0,2,2,1,5,5,2,1,0,0,0,0
Northern Ireland,3,1,1884,1880.4,2,3,2,1,1,0,0,0,2,1,0,0
Wales,36,10,1885,1880.5,26,1,1,2,1,9,0,1,1,0,0,1
Scotland,27,17,1885,1880.5,10,2,1,2,8,9,1,1,0,0,0,1
Northern Ireland,7,4,1885,1880.5,3,3,1,2,2,2,0,0,1,2,0,0
Wales,43,7,1886,1880.6,36,1,2,1,6,1,1,0,1,1,0,0
Scotland,39,12,1886,1880.6,27,2,2,1,5,7,1,1,0,0,1,0
Northern Ireland,10,3,1886,1880.6,7,3,2,1,3,0,0,0,2,1,0,0
Scotland,48,9,1887,1880.7,39,1,1,2,4,5,1,2,0,0,0,0
Wales,44,1,1887,1880.7,43,2,1,2,0,1,0,0,1,2,0,0
Northern Ireland,15,5,1887,1880.7,10,3,1,2,4,1,1,0,0,2,0,0
Scotland,67,19,1888,1880.8,48,1,3,1,9,10,2,1,1,0,0,0
Wales,57,13,1888,1880.8,44,2,1,2,11,2,1,0,0,2,0,0
Northern Ireland,18,3,1888,1880.8,15,3,2,1,3,0,0,0,2,1,0,0
England,15,15,1888,1880.8,0,4,1,2,5,10,1,2,0,0,0,0
Scotland,77,10,1889,1880.9,67,1,1,2,7,3,1,1,0,0,0,1
Wales,61,4,1889,1880.9,57,2,1,2,0,4,0,1,0,1,1,0
Northern Ireland,20,2,1889,1880.9,18,3,1,2,1,1,0,0,1,2,0,0
Scotland,87,10,1890,1890,77,1,2,1,6,4,1,1,0,0,1,0
Wales,67,6,1890,1890,61,2,2,1,6,0,1,0,1,1,0,0
Northern Ireland,24,4,1890,1890,20,3,2,1,2,2,0,0,2,1,0,0
Scotland,93,6,1891,1890.1,87,1,1,1,2,4,1,1,0,0,0,0
Wales,73,6,1891,1890.1,67,2,1,2,3,3,0,0,1,2,0,0
Northern Ireland,33,9,1891,1890.1,24,3,1,2,7,2,1,0,0,2,0,0
Scotland,103,10,1892,1890.2,93,1,2,1,7,3,1,1,1,0,0,0
Wales,75,2,1892,1890.2,73,2,2,1,1,1,0,0,1,1,1,0
Northern Ireland,36,3,1892,1890.2,33,3,2,1,2,1,0,0,2,0,0,1
Scotland,119,16,1893,1890.3,103,1,1,2,6,10,1,1,0,1,0,0
Wales,75,0,1893,1890.3,75,2,1,1,0,0,0,0,1,1,0,0
Scotland,128,9,1894,1890.4,119,1,2,1,7,2,1,1,0,0,1,0
Wales,82,7,1894,1890.4,75,2,2,1,5,2,1,0,1,1,0,0
Northern Ireland,40,4,1894,1890.4,36,3,2,1,3,1,0,0,1,1,1,0
Scotland,133,5,1895,1890.5,128,1,1,2,3,2,1,0,0,1,0,1
Wales,87,5,1895,1890.5,82,2,1,2,2,3,0,0,0,0,1,2
Northern Ireland,43,3,1895,1890.5,40,3,1,2,2,1,0,0,0,2,1,0
Scotland,142,9,1896,1890.6,133,1,2,1,6,3,2,0,0,0,0,1
Wales,94,7,1896,1890.6,87,2,2,1,7,0,1,0,1,1,0,0
Northern Ireland,47,4,1896,1890.6,43,3,2,1,3,1,0,0,1,1,1,0
Scotland,151,9,1897,1890.7,142,1,1,2,5,4,1,1,0,0,0,1
Wales,99,5,1897,1890.7,94,2,1,2,2,3,0,0,0,2,1,0
Northern Ireland,52,5,1897,1890.7,47,3,1,2,4,1,1,0,0,2,0,0
Scotland,160,9,1898,1890.8,151,1,2,1,6,3,1,1,1,0,0,0
Wales,101,2,1898,1890.8,99,2,2,1,0,2,0,0,2,1,0,0
Northern Ireland,55,3,1898,1890.8,52,3,2,1,2,1,0,1,2,0,0,0
Scotland,176,16,1899,1890.9,160,1,1,2,9,7,1,1,0,1,0,0
Wales,101,0,1899,1890.9,101,2,1,2,0,0,0,0,1,2,0,0
Northern Ireland,59,4,1899,1890.9,55,3,1,2,1,3,1,0,0,2,0,0
Scotland,188,12,1900,1900,176,1,2,1,9,3,2,1,0,0,0,0
Wales,106,5,1900,1900,101,2,2,1,3,2,1,0,0,1,1,0
Northern Ireland,59,0,1900,1900,59,3,2,1,0,0,0,0,2,1,0,0
Scotland,202,14,1901,1900.1,188,1,1,2,11,3,1,0,0,0,0,2
Wales,108,2,1901,1900.1,106,2,1,2,1,1,0,1,0,1,1,0
Northern Ireland,59,0,1901,1900.1,59,3,1,2,0,0,0,0,1,2,0,0
Scotland,214,12,1902,1900.2,202,1,1,2,5,7,1,1,0,0,0,1
Wales,109,1,1902,1900.2,108,2,2,1,0,1,0,0,1,1,1,0
Northern Ireland,63,4,1902,1900.2,59,3,2,1,1,3,0,1,2,0,0,0
England,18,3,1902,1900.2,15,4,1,2,2,1,0,1,0,0,1,1
Scotland,217,3,1903,1900.3,214,1,1,2,0,3,0,2,1,0,0,0
Wales,110,1,1903,1900.3,109,2,1,2,0,1,0,0,1,2,0,0
Northern Ireland,67,4,1903,1900.3,63,3,1,1,2,2,1,1,0,0,0,0
Hungary,4,4,1903,1900.3,0,4,1,1,2,2,1,0,0,1,0,0
Scotland,219,2,1904,1900.4,217,1,2,1,1,1,0,0,1,0,1,1
Wales,113,3,1904,1900.4,110,2,2,1,2,1,0,0,1,0,1,1
Northern Ireland,70,3,1904,1900.4,67,3,2,1,2,1,0,1,1,0,1,0
Scotland,224,5,1905,1900.5,219,1,1,2,4,1,1,0,0,2,0,0
Wales,119,6,1905,1900.5,113,2,1,2,3,3,1,0,0,1,0,1
Northern Ireland,73,3,1905,1900.5,70,3,1,2,2,1,0,0,0,1,1,1
Belgium,8,8,1905,1900.5,0,4,2,1,8,0,1,0,1,1,0,0
Netherlands,8,8,1905,1900.5,0,5,1,1,4,4,1,1,0,0,0,0
France,1,1,1905,1900.5,0,6,1,1,1,0,1,0,0,1,0,0
Scotland,227,3,1906,1900.6,224,1,2,1,2,1,1,1,1,0,0,0
Wales,125,6,1906,1900.6,119,2,2,1,4,2,0,1,1,0,1,0
Northern Ireland,77,4,1906,1900.6,73,3,2,1,0,4,0,0,2,0,0,1
Belgium,21,13,1906,1900.6,8,4,1,2,5,8,1,2,0,0,0,0
Hungary,12,8,1906,1900.6,4,5,2,1,4,4,1,0,0,0,1,1
Netherlands,10,2,1906,1900.6,8,6,1,1,2,0,0,0,1,1,0,0
Czech Republic,5,5,1906,1900.6,0,7,1,1,4,1,0,0,0,0,1,1
Argentina,4,4,1906,1900.6,0,8,1,1,2,2,1,1,0,0,0,0
Uruguay,1,1,1906,1900.6,0,9,1,1,0,1,0,0,1,1,0,0
Scotland,231,4,1907,1900.7,227,1,1,2,3,1,1,0,0,1,0,1
Wales,130,5,1907,1900.7,125,2,1,2,1,4,1,1,0,0,0,1
Northern Ireland,79,2,1907,1900.7,77,3,1,2,2,0,0,0,1,2,0,0
Belgium,25,4,1907,1900.7,21,4,2,1,2,2,0,1,2,0,0,0
Hungary,25,13,1907,1900.7,12,5,2,2,9,4,2,0,0,2,0,0
Netherlands,14,4,1907,1900.7,10,6,1,1,1,3,0,1,1,0,0,0
Czech Republic,12,7,1907,1900.7,5,7,1,1,5,2,1,0,0,1,0,0
Austria,4,4,1907,1900.7,0,8,1,1,3,1,1,0,0,1,0,0
Scotland,239,8,1908,1900.8,231,1,2,1,3,5,1,1,0,0,1,0
Wales,132,2,1908,1900.8,130,2,2,1,1,1,0,0,2,1,0,0
Northern Ireland,81,2,1908,1900.8,79,3,2,1,1,1,0,1,2,0,0,0
Hungary,35,10,1908,1900.8,25,4,3,1,10,0,2,0,1,1,0,0
Belgium,31,6,1908,1900.8,25,5,2,2,3,3,1,1,1,1,0,0
Netherlands,30,16,1908,1900.8,14,6,3,1,12,4,3,1,0,0,0,0
Austria,16,12,1908,1900.8,4,7,4,1,9,3,2,0,2,1,0,0
Sweden,15,15,1908,1900.8,0,8,1,2,11,4,1,0,0,2,0,0
Czech Republic,14,2,1908,1900.8,12,9,1,1,0,2,0,0,1,1,0,0
Argentina,8,4,1908,1900.8,4,10,2,1,2,2,1,0,1,0,0,1
France,5,4,1908,1900.8,1,11,1,2,1,3,0,1,1,1,0,0
Uruguay,5,4,1908,1900.8,1,12,1,2,2,2,0,1,0,1,1,0
Scotland,246,7,1909,1900.9,239,1,1,2,5,2,1,0,0,2,0,0
Wales,138,6,1909,1900.9,132,2,1,2,3,3,1,1,0,1,0,0
Northern Ireland,83,2,1909,1900.9,81,3,1,2,2,0,0,0,1,2,0,0
Hungary,47,12,1909,1900.9,35,4,4,1,8,4,0,1,2,0,2,0
England,46,28,1909,1900.9,18,5,3,3,8,20,3,3,0,0,0,0
Belgium,38,7,1909,1900.9,31,6,2,1,6,1,1,0,1,1,0,0
Netherlands,38,8,1909,1900.9,30,7,1,1,4,4,1,1,0,0,0,0
Austria,21,5,1909,1900.9,16,8,2,1,4,1,0,0,2,0,0,1
Argentina,15,7,1909,1900.9,8,9,2,1,5,2,2,0,0,0,0,1
Uruguay,9,4,1909,1900.9,5,10,1,2,2,2,0,0,0,2,1,0
Germany,4,4,1909,1900.9,0,11,1,1,1,3,1,0,0,0,0,1
Scotland,249,3,1910,1910,246,1,2,1,3,0,2,0,0,1,0,0
Wales,142,4,1910,1910,138,2,2,1,4,0,1,0,1,1,0,0
Northern Ireland,86,3,1910,1910,83,3,2,1,2,1,1,0,0,1,1,0
Hungary,57,10,1910,1910,47,4,2,1,9,1,2,0,0,1,0,0
Netherlands,53,15,1910,1910,38,5,2,2,11,4,2,1,0,1,0,0
Belgium,48,10,1910,1910,38,6,1,3,3,7,1,2,0,1,0,0
Argentina,34,19,1910,1910,15,7,5,2,15,4,3,1,1,1,1,0
Austria,23,2,1910,1910,21,8,1,1,2,0,1,0,0,1,0,0
Uruguay,23,14,1910,1910,9,9,1,4,3,11,1,2,0,1,0,1
Germany,10,6,1910,1910,4,10,2,2,1,5,0,1,2,1,0,0
France,7,2,1910,1910,5,11,1,1,0,2,0,0,1,1,0,0
Italy,7,7,1910,1910,0,12,1,1,6,1,1,0,0,1,0,0
Chile,2,2,1910,1910,0,13,2,2,0,2,0,0,2,2,0,0
Scotland,254,5,1911,1910.1,249,1,1,2,2,3,1,0,0,0,0,2
Wales,146,4,1911,1910.1,142,2,1,2,2,2,0,1,0,1,1,0
Northern Ireland,88,2,1911,1910.1,86,3,1,2,1,1,0,0,1,2,0,0
Hungary,77,20,1911,1910.1,57,4,2,5,11,9,2,3,0,2,0,0
Netherlands,61,8,1911,1910.1,53,5,1,1,3,5,1,1,0,0,0,0
Belgium,59,11,1911,1910.1,48,6,3,1,10,1,2,0,1,1,0,0
Argentina,40,6,1911,1910.1,34,7,2,3,2,4,1,1,1,1,0,1
Uruguay,31,8,1911,1910.1,23,8,3,2,6,2,1,1,1,1,1,0
Sweden,29,14,1911,1910.1,15,9,2,2,6,8,1,2,1,0,0,0
Austria,28,5,1911,1910.1,23,10,1,2,3,2,1,1,0,1,0,0
Germany,24,14,1911,1910.1,10,11,4,2,9,5,1,1,3,1,0,0
France,16,9,1911,1910.1,7,12,2,3,2,7,0,1,1,2,1,0
Switzerland,14,14,1911,1910.1,0,13,3,3,10,4,3,0,0,2,0,1
Italy,11,4,1911,1910.1,7,14,2,2,2,2,0,0,1,1,1,1
Scotland,260,6,1912,1910.2,254,1,2,1,2,4,1,1,0,0,1,0
Wales,148,2,1912,1910.2,146,2,2,1,2,0,0,0,2,1,0,0
Hungary,115,38,1912,1910.2,77,3,2,5,8,30,1,3,0,0,1,2
Northern Ireland,93,5,1912,1910.2,88,4,2,1,2,3,0,1,2,0,0,0
Netherlands,75,14,1912,1910.2,61,5,2,2,9,5,1,2,0,0,1,0
Belgium,73,14,1912,1910.2,59,6,2,2,10,4,1,0,1,1,0,1
Argentina,46,6,1912,1910.2,40,7,2,3,3,3,0,1,1,2,1,0
Sweden,44,15,1912,1910.2,29,8,3,1,13,2,2,1,0,0,1,0
Uruguay,41,10,1912,1910.2,31,9,3,2,6,4,2,1,1,0,0,1
Germany,38,14,1912,1910.2,24,10,1,4,2,12,0,1,1,1,0,2
Austria,32,4,1912,1910.2,28,11,1,2,1,3,0,1,0,1,1,0
France,25,9,1912,1910.2,16,12,2,1,5,4,1,1,0,0,1,0
Switzerland,18,4,1912,1910.2,14,13,1,2,1,3,0,0,1,2,0,0
Norway,5,5,1912,1910.2,0,14,3,1,3,2,1,0,2,1,0,0
Russia,1,1,1912,1910.2,0,15,2,1,0,1,0,0,2,1,0,0
Wales,152,4,1913,1910.3,148,1,1,2,0,4,0,1,0,1,1,0
Hungary,125,10,1913,1910.3,115,2,2,1,6,4,2,1,0,0,0,0
Belgium,93,20,1913,1910.3,73,3,4,3,14,6,3,2,0,1,1,0
Netherlands,80,5,1913,1910.3,75,4,1,1,2,3,0,0,1,0,0,1
Sweden,58,14,1913,1910.3,44,5,2,4,9,5,1,1,1,2,0,1
Argentina,57,11,1913,1910.3,46,6,4,3,9,2,3,1,0,2,1,0
England,52,6,1913,1910.3,46,7,2,1,5,1,2,0,0,1,0,0
Uruguay,45,4,1913,1910.3,41,8,2,4,2,2,2,0,0,3,0,1
Germany,42,4,1913,1910.3,38,9,2,1,2,2,0,0,2,1,0,0
Austria,38,6,1913,1910.3,32,10,2,1,3,3,1,0,1,1,0,0
France,38,13,1913,1910.3,25,11,2,2,9,4,2,1,0,1,0,0
Denmark,22,22,1913,1910.3,0,12,1,2,8,14,1,2,0,0,0,0
Switzerland,22,4,1913,1910.3,18,13,2,2,2,2,0,1,2,1,0,0
Italy,12,1,1913,1910.3,11,14,1,2,1,0,1,0,0,2,0,0
Norway,7,2,1913,1910.3,5,15,1,2,1,1,0,0,0,1,1,1
Scotland,261,1,1914,1910.4,260,1,1,1,0,1,0,0,0,0,1,1
Wales,153,1,1914,1910.4,152,2,2,1,1,0,0,0,2,0,0,1
Hungary,135,10,1914,1910.4,125,3,2,3,7,3,1,1,0,1,1,1
Belgium,100,7,1914,1910.4,93,4,1,2,2,5,0,0,1,2,0,0
Northern Ireland,99,6,1914,1910.4,93,5,1,2,1,5,0,2,0,0,1,0
Netherlands,95,15,1914,1910.4,80,6,2,2,8,7,1,1,0,1,1,0
Sweden,73,15,1914,1910.4,58,7,4,1,14,1,2,1,0,0,2,0
Argentina,64,7,1914,1910.4,57,8,3,1,5,2,2,0,1,1,0,0
England,54,2,1914,1910.4,52,9,1,1,0,2,0,1,1,0,0,0
France,49,11,1914,1910.4,38,10,2,3,6,5,1,0,0,3,1,0
Uruguay,49,4,1914,1910.4,45,11,1,1,3,1,1,0,0,1,0,0
Austria,43,5,1914,1910.4,38,12,2,2,3,2,1,0,1,0,0,2
Switzerland,25,3,1914,1910.4,22,13,1,2,0,3,0,0,1,0,0,2
Italy,16,4,1914,1910.4,12,14,3,1,3,1,1,1,0,0,2,0
Norway,8,1,1914,1910.4,7,15,2,1,1,0,0,0,1,1,1,0
Hungary,147,12,1915,1910.5,135,1,2,2,8,4,1,1,1,1,0,0
Sweden,79,6,1915,1910.5,73,2,2,2,5,1,1,0,1,1,0,1
Argentina,69,5,1915,1910.5,64,3,1,2,2,3,1,1,0,1,0,0
Austria,55,12,1915,1910.5,43,4,2,2,5,7,1,1,1,1,0,0
Uruguay,54,5,1915,1910.5,49,5,2,1,4,1,1,0,1,1,0,0
Denmark,34,12,1915,1910.5,22,6,2,1,10,2,2,1,0,0,0,0
Norway,12,4,1915,1910.5,8,7,1,2,1,3,0,0,0,2,1,0
Hungary,155,8,1916,1910.6,147,1,2,2,4,4,1,0,1,1,0,1
Argentina,91,22,1916,1910.6,69,2,6,3,18,4,4,2,0,1,2,0
Sweden,91,12,1916,1910.6,79,3,3,2,12,0,2,0,1,1,0,1
Uruguay,71,17,1916,1910.6,54,4,5,5,8,9,2,2,3,2,0,1
Austria,65,10,1916,1910.6,55,5,2,2,6,4,1,1,0,1,1,0
Denmark,46,12,1916,1910.6,34,6,2,2,10,2,2,1,0,1,0,0
Norway,13,1,1916,1910.6,12,7,3,2,1,0,0,0,1,2,2,0
Chile,5,3,1916,1910.6,2,8,1,4,0,3,0,0,1,3,0,1
Brazil,4,4,1916,1910.6,0,9,2,2,2,2,0,1,1,0,1,1
Hungary,170,15,1917,1910.7,155,1,2,3,8,7,2,2,0,0,0,1
Argentina,99,8,1917,1910.7,91,2,3,3,6,2,3,1,0,2,0,0
Sweden,98,7,1917,1910.7,91,3,2,2,4,3,0,1,1,0,1,1
Uruguay,84,13,1917,1910.7,71,4,6,1,13,0,5,0,1,1,0,0
Austria,74,9,1917,1910.7,65,5,3,4,3,6,0,1,2,3,1,0
Denmark,63,17,1917,1910.7,46,6,2,2,13,4,1,2,0,0,1,0
Norway,17,4,1917,1910.7,13,7,2,2,1,3,0,0,2,1,0,1
Brazil,12,8,1917,1910.7,4,8,1,3,5,3,1,0,0,3,0,0
Hungary,179,9,1918,1910.8,170,1,2,2,4,5,2,2,0,0,0,0
Argentina,106,7,1918,1910.8,99,2,3,3,4,3,2,0,0,1,1,2
Sweden,102,4,1918,1910.8,98,3,2,2,3,1,1,0,1,2,0,0
Uruguay,90,6,1918,1910.8,84,4,3,3,5,1,1,0,0,2,2,1
Austria,79,5,1918,1910.8,74,5,3,1,5,0,1,0,2,1,0,0
Denmark,73,10,1918,1910.8,63,6,2,2,7,3,2,1,0,1,0,0
Norway,22,5,1918,1910.8,17,7,2,2,5,0,2,0,0,2,0,0
Hungary,184,5,1919,1910.9,179,1,2,1,5,0,2,0,0,1,0,0
Argentina,139,33,1919,1910.9,106,2,4,9,13,20,2,4,2,4,0,1
Sweden,118,16,1919,1910.9,102,3,4,4,9,7,3,0,1,3,0,1
Uruguay,110,20,1919,1910.9,90,4,3,6,10,10,3,3,0,2,0,1
Netherlands,100,5,1919,1910.9,95,5,1,2,3,2,1,0,0,1,0,1
Austria,84,5,1919,1910.9,79,6,1,2,2,3,1,0,0,2,0,0
Denmark,83,10,1919,1910.9,73,7,2,2,8,2,2,0,0,2,0,0
Norway,36,14,1919,1910.9,22,8,3,2,8,6,2,1,0,1,1,0
Chile,6,1,1919,1910.9,5,9,1,2,0,1,0,0,1,2,0,0
Finland,3,3,1919,1910.9,0,10,1,1,3,0,0,0,0,1,1,0
Scotland,269,8,1920,1920,261,1,1,2,3,5,1,0,0,1,0,1
Hungary,187,3,1920,1920,184,2,1,2,1,2,0,0,1,1,0,1
Wales,158,5,1920,1920,153,3,1,2,1,4,0,1,0,0,1,1
Argentina,145,6,1920,1920,139,4,3,3,4,2,2,0,1,1,0,2
Sweden,125,7,1920,1920,118,5,4,2,4,3,1,1,2,1,1,0
Uruguay,124,14,1920,1920,110,6,2,4,3,11,1,3,0,1,1,0
Netherlands,104,4,1920,1920,100,7,1,2,2,2,1,0,0,1,0,1
Northern Ireland,101,2,1920,1920,99,8,1,2,2,0,0,0,0,2,1,0
Austria,91,7,1920,1920,84,9,2,1,5,2,1,1,0,0,1,0
France,57,8,1920,1920,49,10,1,2,2,6,1,1,0,1,0,0
Germany,46,4,1920,1920,42,11,1,2,1,3,1,0,0,2,0,0
Norway,37,1,1920,1920,36,12,2,1,1,0,0,0,1,0,1,1
Switzerland,35,10,1920,1920,25,13,4,1,9,1,3,1,1,0,0,0
Italy,26,10,1920,1920,16,14,2,1,10,0,1,0,0,1,1,0
Brazil,13,1,1920,1920,12,15,1,2,0,1,0,1,1,1,0,0
Finland,10,7,1920,1920,3,16,2,1,7,0,2,0,0,1,0,0
Scotland,277,8,1921,1920.1,269,1,2,2,5,3,2,2,0,0,0,0
Hungary,196,9,1921,1920.1,187,2,3,1,8,1,3,0,0,1,0,0
Wales,161,3,1921,1920.1,158,3,2,1,2,1,1,0,0,1,1,0
Argentina,158,13,1921,1920.1,145,4,3,4,5,8,3,1,0,1,0,2
Sweden,133,8,1921,1920.1,125,5,4,5,1,7,0,0,3,2,1,3
Uruguay,131,7,1921,1920.1,124,6,1,3,4,3,1,1,0,2,0,0
Netherlands,113,9,1921,1920.1,104,7,1,3,2,7,0,1,0,0,1,2
Austria,108,17,1921,1920.1,91,8,2,4,6,11,1,2,0,0,1,2
Northern Ireland,103,2,1921,1920.1,101,9,2,1,1,1,0,0,1,1,1,0
Denmark,87,4,1921,1920.1,83,10,2,1,4,0,1,0,0,0,1,1
France,59,2,1921,1920.1,57,11,2,1,1,1,0,0,2,1,0,0
Germany,52,6,1921,1920.1,46,12,1,2,3,3,0,0,0,1,1,1
Norway,47,10,1921,1920.1,37,13,2,2,6,4,2,1,0,1,0,0
Switzerland,39,4,1921,1920.1,35,14,2,1,3,1,0,0,0,1,2,0
Italy,36,10,1921,1920.1,26,15,1,4,2,8,1,2,0,0,0,2
Finland,23,13,1921,1920.1,10,16,2,3,5,8,0,2,1,1,1,0
Brazil,17,4,1921,1920.1,13,17,2,1,4,0,1,0,1,1,0,0
Costa Rica,13,13,1921,1920.1,0,18,1,1,7,6,1,1,0,0,0,0
Paraguay,9,9,1921,1920.1,0,19,3,3,7,2,2,0,0,3,1,0
Scotland,281,4,1922,1920.2,277,1,1,2,2,2,1,1,0,1,0,0
Hungary,210,14,1922,1920.2,196,2,3,5,3,11,0,2,1,0,2,3
Argentina,168,10,1922,1920.2,158,3,5,4,9,1,3,0,1,4,1,0
Wales,163,2,1922,1920.2,161,4,1,1,2,0,1,0,0,1,0,0
Sweden,146,13,1922,1920.2,133,5,4,3,2,11,0,3,2,0,2,0
Uruguay,138,7,1922,1920.2,131,6,2,5,2,5,2,2,0,1,0,2
Austria,123,15,1922,1920.2,108,7,3,3,9,6,1,1,1,0,1,2
Netherlands,116,3,1922,1920.2,113,8,2,2,3,0,1,0,1,2,0,0
Belgium,109,9,1922,1920.2,100,9,2,3,4,5,1,1,0,2,1,0
Denmark,91,4,1922,1920.2,87,10,2,3,1,3,0,0,2,1,0,2
Norway,62,15,1922,1920.2,47,11,4,2,12,3,2,1,1,0,1,1
France,61,2,1922,1920.2,59,12,2,1,2,0,1,0,1,1,0,0
Germany,56,4,1922,1920.2,52,13,2,1,2,2,0,1,0,0,2,0
Switzerland,50,11,1922,1920.2,39,14,1,4,5,6,1,0,0,1,0,3
Paraguay,15,6,1922,1920.2,9,15,1,5,1,5,1,1,0,3,0,1
Chile,7,1,1922,1920.2,6,16,2,3,0,1,0,0,2,2,0,1
Poland,3,3,1922,1920.2,0,17,1,2,0,3,0,1,1,0,0,1
Scotland,286,5,1923,1920.3,281,1,2,1,4,1,1,1,0,0,1,0
Hungary,223,13,1923,1920.3,210,2,3,3,7,6,3,1,0,1,0,1
Argentina,189,21,1923,1920.3,168,3,9,3,17,4,5,1,2,1,2,1
Sweden,167,21,1923,1920.3,146,4,6,3,15,6,3,1,3,1,0,1
Wales,165,2,1923,1920.3,163,5,2,1,2,0,0,0,1,1,1,0
Uruguay,150,12,1923,1920.3,138,6,6,2,10,2,4,0,1,0,1,2
Netherlands,129,13,1923,1920.3,116,7,3,1,13,0,2,0,0,0,1,1
Austria,128,5,1923,1920.3,123,8,3,3,3,2,2,0,0,3,1,0
Belgium,118,9,1923,1920.3,109,9,3,2,7,2,2,0,0,1,1,1
Northern Ireland,108,5,1923,1920.3,103,10,2,1,2,3,1,1,1,0,0,0
Denmark,99,8,1923,1920.3,91,11,2,2,5,3,2,1,0,1,0,0
England,78,24,1923,1920.3,54,12,1,7,6,18,1,3,0,1,0,3
Norway,72,10,1923,1920.3,62,13,3,3,7,3,1,1,1,2,1,0
France,66,5,1923,1920.3,61,14,3,3,3,2,0,0,2,3,1,0
Germany,62,6,1923,1920.3,56,15,3,3,2,4,1,1,1,2,1,0
Switzerland,61,11,1923,1920.3,50,16,3,4,4,7,1,0,2,2,0,2
Italy,40,4,1923,1920.3,36,17,2,2,3,1,1,0,0,1,1,1
Finland,37,14,1923,1920.3,23,18,1,6,5,9,1,1,0,5,0,0
Czech Republic,27,13,1923,1920.3,14,19,2,1,7,6,2,1,0,0,0,0
Brazil,23,6,1923,1920.3,17,20,2,4,2,4,1,1,1,3,0,0
Mexico,15,15,1923,1920.3,0,21,3,3,7,8,2,2,0,1,1,0
Poland,13,10,1923,1920.3,3,22,2,2,3,7,0,1,0,1,2,0
Estonia,11,11,1923,1920.3,0,23,4,1,6,5,1,1,2,0,1,0
Guatemala,10,10,1923,1920.3,0,24,3,3,6,4,1,0,2,2,0,1
China,8,8,1923,1920.3,0,25,1,1,3,5,1,1,0,0,0,0
Spain,6,6,1923,1920.3,0,26,2,1,6,0,2,0,0,1,0,0
Romania,3,3,1923,1920.3,0,27,1,2,0,3,0,0,1,0,0,2
Scotland,289,3,1924,1920.4,286,1,1,2,2,1,1,0,0,1,0,1
Hungary,244,21,1924,1920.4,223,2,4,3,17,4,3,1,0,2,1,0
Sweden,205,38,1924,1920.4,167,3,4,5,21,17,4,3,0,0,0,2
Argentina,202,13,1924,1920.4,189,4,4,5,8,5,3,1,0,2,1,2
Wales,170,5,1924,1920.4,165,5,1,2,2,3,1,2,0,0,0,0
Uruguay,162,12,1924,1920.4,150,6,5,2,11,1,3,0,0,2,2,0
Austria,154,26,1924,1920.4,128,7,5,4,16,10,4,1,0,2,1,1
Netherlands,133,4,1924,1920.4,129,8,3,1,3,1,1,0,1,0,1,1
Belgium,124,6,1924,1920.4,118,9,2,4,4,2,1,0,0,3,1,1
Northern Ireland,110,2,1924,1920.4,108,10,2,2,1,1,0,0,2,2,0,0
Denmark,106,7,1924,1920.4,99,11,2,2,4,3,1,1,1,1,0,0
England,90,12,1924,1920.4,78,12,4,1,9,3,2,1,1,0,1,0
Norway,74,2,1924,1920.4,72,13,2,2,1,1,0,0,2,2,0,0
Germany,72,10,1924,1920.4,62,14,4,3,6,4,1,2,2,1,1,0
Switzerland,71,10,1924,1920.4,61,15,3,1,9,1,3,0,0,0,0,1
France,69,3,1924,1920.4,66,16,3,2,3,0,1,0,2,2,0,0
Finland,52,15,1924,1920.4,37,17,4,2,13,2,2,1,2,1,0,0
Italy,44,4,1924,1920.4,40,18,3,2,2,2,0,1,1,1,2,0
Paraguay,22,7,1924,1920.4,15,19,2,3,3,4,1,1,1,1,0,1
Poland,19,6,1924,1920.4,13,20,3,2,5,1,2,0,1,2,0,0
Estonia,15,4,1924,1920.4,11,21,2,3,2,2,0,0,2,3,0,0
Egypt,11,11,1924,1920.4,0,22,1,2,10,1,1,0,0,2,0,0
Chile,8,1,1924,1920.4,7,23,1,2,1,0,0,0,1,2,0,0
Spain,8,2,1924,1920.4,6,24,1,1,2,0,1,0,0,0,0,1
Scotland,300,11,1925,1920.5,289,1,2,2,5,6,2,2,0,0,0,0
Hungary,257,13,1925,1920.5,244,2,5,4,8,5,1,1,2,3,2,0
Sweden,231,26,1925,1920.5,205,3,5,2,13,13,3,2,2,0,0,0
Austria,175,21,1925,1920.5,154,4,3,7,5,16,2,4,1,2,0,1
Wales,172,2,1925,1920.5,170,5,3,1,1,1,0,0,2,1,1,0
Uruguay,163,1,1925,1920.5,162,6,2,3,0,1,0,1,2,1,0,1
Netherlands,146,13,1925,1920.5,133,7,3,2,11,2,3,1,0,1,0,0
Belgium,130,6,1925,1920.5,124,8,2,3,3,3,0,1,2,1,0,1
Denmark,118,12,1925,1920.5,106,9,2,2,8,4,1,1,0,1,1,0
Northern Ireland,110,0,1925,1920.5,110,10,2,1,0,0,0,0,1,0,1,1
Norway,79,5,1925,1920.5,74,11,2,1,4,1,1,0,1,1,0,0
Switzerland,77,6,1925,1920.5,71,12,5,2,6,0,2,0,2,2,1,0
France,71,2,1925,1920.5,69,13,2,1,2,0,0,0,2,1,0,0
Finland,64,12,1925,1920.5,52,14,4,4,9,3,1,0,2,3,1,1
Italy,52,8,1925,1920.5,44,15,1,3,7,1,1,0,0,2,0,1
Brazil,34,11,1925,1920.5,23,16,2,2,8,3,2,0,0,1,0,1
Paraguay,31,9,1925,1920.5,22,17,3,8,1,8,1,2,1,4,1,2
Poland,25,6,1925,1920.5,19,18,2,2,2,4,0,1,2,0,0,1
Estonia,20,5,1925,1920.5,15,19,2,1,4,1,1,1,0,0,1,0
China,15,7,1925,1920.5,8,20,1,1,2,5,1,1,0,0,0,0
Spain,14,6,1925,1920.5,8,21,1,3,1,5,1,3,0,0,0,0
Romania,8,5,1925,1920.5,3,22,1,1,1,4,0,1,1,0,0,0
Turkey,6,6,1925,1920.5,0,23,3,1,4,2,1,1,2,0,0,0
USA,6,6,1925,1920.5,0,24,1,1,6,0,1,0,0,1,0,0
Latvia,5,5,1925,1920.5,0,25,1,2,2,3,0,0,0,1,1,1
Bulgaria,3,3,1925,1920.5,0,26,1,1,2,1,0,0,1,1,0,0
Canada,2,2,1925,1920.5,0,27,1,1,1,1,1,0,0,1,0,0
Lithuania,2,2,1925,1920.5,0,28,1,1,0,2,0,0,1,0,0,1
Scotland,308,8,1926,1920.6,300,1,2,1,7,1,2,1,0,0,0,0
Hungary,276,19,1926,1920.6,257,2,4,4,9,10,3,2,1,1,0,1
Sweden,262,31,1926,1920.6,231,3,4,8,13,18,3,2,0,5,1,1
Argentina,220,18,1926,1920.6,202,4,5,1,17,1,4,0,1,0,0,1
Austria,198,23,1926,1920.6,175,5,5,2,18,5,4,2,1,0,0,0
Netherlands,158,12,1926,1920.6,146,6,3,3,8,4,1,0,2,2,0,1
Belgium,144,14,1926,1920.6,130,7,4,2,6,8,0,1,2,1,2,0
Denmark,128,10,1926,1920.6,118,8,2,2,6,4,2,0,0,1,0,1
Northern Ireland,116,6,1926,1920.6,110,9,1,2,3,3,1,0,0,1,0,1
England,99,9,1926,1920.6,90,10,3,1,4,5,0,1,2,0,1,0
Norway,88,9,1926,1920.6,79,11,1,2,2,7,0,1,0,1,1,0
Germany,84,12,1926,1920.6,72,12,3,1,9,3,1,1,1,0,1,0
Switzerland,84,7,1926,1920.6,77,13,1,5,1,6,0,1,0,4,1,0
France,83,12,1926,1920.6,71,14,3,2,9,3,3,0,0,1,0,1
Finland,77,13,1926,1920.6,64,15,4,2,8,5,1,1,2,1,1,0
Italy,66,14,1926,1920.6,52,16,3,3,9,5,3,0,0,2,0,1
Poland,42,17,1926,1920.6,25,17,3,2,15,2,3,0,0,2,0,0
Paraguay,41,10,1926,1920.6,31,18,1,5,1,9,0,1,1,4,0,0
Czech Republic,39,12,1926,1920.6,27,19,3,4,8,4,2,0,1,3,0,1
Estonia,26,6,1926,1920.6,20,20,2,3,4,2,1,1,1,1,0,1
Romania,17,9,1926,1920.6,8,21,1,1,6,3,1,1,0,0,0,0
Latvia,13,8,1926,1920.6,5,22,3,1,5,3,1,1,2,0,0,0
Turkey,8,2,1926,1920.6,6,23,1,1,1,1,0,0,1,1,0,0
Haiti,5,5,1926,1920.6,0,24,4,1,5,0,1,0,1,1,2,0
Lithuania,5,3,1926,1920.6,2,25,1,1,2,1,0,0,1,1,0,0
Portugal,5,5,1926,1920.6,0,26,1,1,3,2,0,0,0,1,1,0
Bolivia,2,2,1926,1920.6,0,27,2,2,1,1,0,0,2,2,0,0
Scotland,313,5,1927,1920.7,308,1,1,2,1,4,0,1,1,0,0,1
Sweden,298,36,1927,1920.7,262,2,5,4,28,8,4,1,0,2,1,1
Hungary,296,20,1927,1920.7,276,3,3,2,19,1,2,0,1,2,0,0
Argentina,236,16,1927,1920.7,220,4,3,2,10,6,2,2,1,0,0,0
Austria,216,18,1927,1920.7,198,5,2,4,10,8,2,2,0,2,0,0
Uruguay,182,19,1927,1920.7,163,6,1,5,0,19,0,4,1,1,0,0
Netherlands,165,7,1927,1920.7,158,7,2,3,4,3,2,0,0,1,0,2
Belgium,154,10,1927,1920.7,144,8,4,4,7,3,2,0,2,4,0,0
Denmark,136,8,1927,1920.7,128,9,3,2,7,1,2,1,0,0,1,1
Northern Ireland,120,4,1927,1920.7,116,10,2,1,2,2,1,0,1,0,0,1
Norway,97,9,1927,1920.7,88,11,3,2,6,3,1,0,2,2,0,0
Germany,93,9,1927,1920.7,84,12,2,1,8,1,1,0,0,1,1,0
France,88,5,1927,1920.7,83,13,3,2,4,1,0,0,2,2,1,0
Switzerland,88,4,1927,1920.7,84,14,3,1,4,0,0,0,2,1,1,0
Finland,84,7,1927,1920.7,77,15,1,3,3,4,1,0,0,3,0,0
Italy,83,17,1927,1920.7,66,16,4,3,7,10,2,1,1,0,1,2
Czech Republic,58,19,1927,1920.7,39,17,4,3,12,7,3,2,0,0,1,1
Estonia,39,13,1927,1920.7,26,18,2,3,6,7,2,1,0,2,0,0
Latvia,25,12,1927,1920.7,13,19,2,3,10,2,2,0,0,3,0,0
Spain,19,5,1927,1920.7,14,20,1,2,1,4,1,1,0,1,0,0
Turkey,14,6,1927,1920.7,8,21,1,1,3,3,1,0,0,0,0,1
Portugal,10,5,1927,1920.7,5,22,1,1,4,1,1,0,0,1,0,0
Lithuania,8,3,1927,1920.7,5,23,1,1,0,3,0,0,1,1,0,0
Bulgaria,7,4,1927,1920.7,3,24,1,1,3,1,0,0,0,1,1,0
Bolivia,5,3,1927,1920.7,2,25,1,2,0,3,0,0,1,2,0,0
Japan,3,3,1927,1920.7,0,26,1,1,2,1,1,0,0,1,0,0
Scotland,322,9,1928,1920.8,313,1,2,1,4,5,1,1,1,0,0,0
Sweden,318,20,1928,1920.8,298,2,3,5,10,10,2,3,1,2,0,0
Hungary,311,15,1928,1920.8,296,3,3,3,10,5,2,0,0,3,1,0
Argentina,239,3,1928,1920.8,236,4,1,2,1,2,1,0,0,0,0,2
Austria,235,19,1928,1920.8,216,5,3,4,7,12,2,2,1,0,0,2
Uruguay,186,4,1928,1920.8,182,6,1,3,2,2,0,0,0,2,1,1
Wales,178,6,1928,1920.8,172,7,1,2,2,4,0,1,1,1,0,0
Netherlands,173,8,1928,1920.8,165,8,4,3,5,3,1,0,1,3,2,0
Belgium,164,10,1928,1920.8,154,9,4,3,5,5,1,1,3,0,0,2
Denmark,143,7,1928,1920.8,136,10,1,3,3,4,1,1,0,2,0,0
Northern Ireland,123,3,1928,1920.8,120,11,1,3,1,2,0,1,1,2,0,0
England,113,14,1928,1920.8,99,12,2,3,3,11,1,3,1,0,0,0
Norway,106,9,1928,1920.8,97,13,2,2,2,7,0,1,2,1,0,0
Switzerland,104,16,1928,1920.8,88,14,4,4,10,6,2,0,2,4,0,0
Germany,100,7,1928,1920.8,93,15,1,3,2,5,1,2,0,1,0,0
Italy,100,17,1928,1920.8,83,16,4,3,12,5,3,1,0,1,1,1
France,99,11,1928,1920.8,88,17,5,1,8,3,1,0,3,1,1,0
Finland,91,7,1928,1920.8,84,18,3,2,4,3,0,1,2,1,1,0
Czech Republic,70,12,1928,1920.8,58,19,2,3,9,3,2,2,0,1,0,0
Poland,49,7,1928,1920.8,42,20,2,1,5,2,1,0,0,1,1,0
Estonia,48,9,1928,1920.8,39,21,3,2,6,3,1,0,2,0,0,2
Latvia,33,8,1928,1920.8,25,22,4,2,6,2,2,1,1,0,1,1
Spain,22,3,1928,1920.8,19,23,1,1,1,2,0,0,0,0,1,1
Portugal,17,7,1928,1920.8,10,24,3,1,6,1,1,0,0,0,2,1
Lithuania,9,1,1928,1920.8,8,25,1,2,1,0,0,0,0,2,1,0
Sweden,345,27,1929,1920.9,318,1,5,2,26,1,5,0,0,2,0,0
Scotland,344,22,1929,1920.9,322,2,1,5,1,21,1,4,0,0,0,1
Hungary,321,10,1929,1920.9,311,3,1,4,2,8,1,1,0,1,0,2
Argentina,252,13,1929,1920.9,239,4,5,2,11,2,4,0,0,1,1,1
Austria,249,14,1929,1920.9,235,5,3,3,7,7,2,1,0,1,1,1
Uruguay,193,7,1929,1920.9,186,6,2,5,3,4,1,1,0,3,1,1
Netherlands,184,11,1929,1920.9,173,7,3,3,4,7,1,0,2,2,0,1
Wales,182,4,1929,1920.9,178,8,2,1,4,0,0,0,1,1,1,0
Belgium,172,8,1929,1920.9,164,9,3,1,8,0,2,0,1,1,0,0
Denmark,155,12,1929,1920.9,143,10,2,1,10,2,1,0,1,1,0,0
England,134,21,1929,1920.9,113,11,1,5,6,15,1,3,0,2,0,0
Northern Ireland,128,5,1929,1920.9,123,12,2,1,3,2,0,0,2,0,0,1
Norway,128,22,1929,1920.9,106,13,4,2,13,9,2,2,1,0,1,0
Germany,117,17,1929,1920.9,100,14,4,1,15,2,3,1,0,0,1,0
Switzerland,113,9,1929,1920.9,104,15,3,3,6,3,0,0,3,3,0,0
Italy,111,11,1929,1920.9,100,16,3,1,11,0,2,0,1,1,0,0
France,107,8,1929,1920.9,99,17,3,2,6,2,2,0,1,2,0,0
Finland,98,7,1929,1920.9,91,18,2,5,5,2,2,0,0,4,0,1
Czech Republic,86,16,1929,1920.9,70,19,3,3,9,7,1,1,0,2,2,0
Estonia,62,14,1929,1920.9,48,20,3,3,10,4,2,0,0,2,1,1
Paraguay,50,9,1929,1920.9,41,21,2,1,8,1,2,0,0,1,0,0
Latvia,40,7,1929,1920.9,33,22,2,3,5,2,1,0,0,3,1,0
Romania,23,6,1929,1920.9,17,23,1,1,3,3,1,1,0,0,0,0
Bulgaria,10,3,1929,1920.9,7,24,2,1,3,0,0,0,1,1,1,0
Trinidad and Tobago,5,5,1929,1920.9,0,25,5,3,4,1,1,0,2,3,2,0
Peru,1,1,1929,1920.9,0,26,1,2,1,0,0,0,1,2,0,0
Sweden,370,25,1930,1930,345,1,3,6,7,18,2,2,1,2,0,2
Scotland,352,8,1930,1930,344,2,2,2,4,4,1,1,0,1,1,0
Hungary,339,18,1930,1930,321,3,4,4,9,9,2,1,1,1,1,2
Argentina,271,19,1930,1930,252,4,5,1,17,2,4,0,0,1,1,0
Austria,258,9,1930,1930,249,5,3,2,6,3,1,0,1,1,1,1
Uruguay,203,10,1930,1930,193,6,3,1,9,1,3,0,0,0,0,1
Belgium,193,21,1930,1930,172,7,8,3,11,10,2,1,5,0,1,2
Netherlands,193,9,1930,1930,184,8,2,3,3,6,0,0,0,3,2,0
Wales,183,1,1930,1930,182,9,1,2,0,1,0,0,1,1,0,1
Denmark,173,18,1930,1930,155,10,2,2,12,6,2,1,0,1,0,0
England,151,17,1930,1930,134,11,2,3,10,7,2,1,0,0,0,2
Norway,142,14,1930,1930,128,12,3,2,10,4,3,0,0,1,0,1
Northern Ireland,137,9,1930,1930,128,13,1,2,7,2,1,0,0,2,0,0
Germany,134,17,1930,1930,117,14,4,2,9,8,1,1,1,1,2,0
Switzerland,126,13,1930,1930,113,15,3,4,8,5,1,0,1,3,1,1
Italy,125,14,1930,1930,111,16,2,3,6,8,1,2,1,0,0,1
France,123,16,1930,1930,107,17,6,5,12,4,1,1,3,4,2,0
Finland,105,7,1930,1930,98,18,2,3,5,2,0,0,1,3,1,0
Czech Republic,98,12,1930,1930,86,19,3,5,5,7,1,2,0,2,2,1
Estonia,71,9,1930,1930,62,20,4,1,8,1,1,0,2,1,1,0
Poland,58,9,1930,1930,49,21,1,1,6,3,1,1,0,0,0,0
Paraguay,51,1,1930,1930,50,22,1,1,0,1,0,1,1,0,0,0
Latvia,50,10,1930,1930,40,23,2,4,3,7,1,1,1,1,0,2
Brazil,45,11,1930,1930,34,24,2,1,7,4,2,1,0,0,0,0
Romania,37,14,1930,1930,23,25,1,3,8,6,1,1,0,2,0,0
Spain,27,5,1930,1930,22,26,1,3,1,4,1,2,0,1,0,0
China,23,8,1930,1930,15,27,1,1,5,3,1,0,0,0,0,1
Portugal,21,4,1930,1930,17,28,3,1,3,1,2,0,1,1,0,0
Bulgaria,16,6,1930,1930,10,29,1,1,5,1,1,0,0,1,0,0
Chile,13,5,1930,1930,8,30,2,1,4,1,2,0,0,1,0,0
Greece,7,7,1930,1930,0,31,1,1,6,1,1,0,0,1,0,0
Uganda,5,5,1930,1930,0,32,1,1,5,0,1,0,0,0,0,1
Peru,2,1,1930,1930,1,33,1,1,1,0,0,0,1,1,0,0
Kenya,0,0,1930,1930,0,34,1,1,0,0,0,0,0,1,1,0
Sweden,392,22,1931,1930.1,370,1,5,2,20,2,4,0,0,2,1,0
Scotland,363,11,1931,1930.1,352,2,2,5,5,6,2,2,0,2,0,1
Hungary,362,23,1931,1930.1,339,3,4,4,14,9,3,1,0,1,1,2
Austria,289,31,1931,1930.1,258,4,5,4,14,17,4,2,0,1,1,1
Argentina,277,6,1931,1930.1,271,5,2,2,4,2,1,1,0,0,1,1
Belgium,206,13,1931,1930.1,193,6,4,2,9,4,3,0,1,2,0,0
Netherlands,205,12,1931,1930.1,193,7,2,3,4,8,1,2,0,1,1,0
Wales,189,6,1931,1930.1,183,8,2,2,5,1,1,0,1,2,0,0
Denmark,181,8,1931,1930.1,173,9,3,2,5,3,1,0,2,2,0,0
England,173,22,1931,1930.1,151,10,2,4,10,12,2,2,0,2,0,0
Norway,151,9,1931,1930.1,142,11,2,2,4,5,1,0,0,1,1,1
Northern Ireland,146,9,1931,1930.1,137,12,3,2,6,3,1,0,1,2,1,0
Italy,143,18,1931,1930.1,125,13,5,3,15,3,4,1,0,0,1,2
Germany,141,7,1931,1930.1,134,14,2,5,4,3,1,0,1,2,0,3
Switzerland,136,10,1931,1930.1,126,15,3,4,4,6,0,0,2,4,1,0
France,133,10,1931,1930.1,123,16,4,1,10,0,2,0,2,1,0,0
Finland,121,16,1931,1930.1,105,17,3,2,11,5,2,1,0,1,1,0
Czech Republic,117,19,1931,1930.1,98,18,2,5,10,9,1,2,0,2,1,1
Estonia,84,13,1931,1930.1,71,19,3,4,9,4,3,1,0,3,0,0
Poland,61,3,1931,1930.1,58,20,2,1,2,1,0,0,2,1,0,0
Latvia,59,9,1931,1930.1,50,21,4,3,8,1,3,0,1,3,0,0
Paraguay,54,3,1931,1930.1,51,22,2,2,1,2,0,0,1,1,1,1
Romania,53,16,1931,1930.1,37,23,1,3,5,11,1,3,0,0,0,0
Spain,34,7,1931,1930.1,27,24,2,2,1,6,0,1,0,1,2,0
Bulgaria,25,9,1931,1930.1,16,25,2,1,7,2,2,0,0,1,0,0
Lithuania,14,5,1931,1930.1,9,26,1,4,2,3,0,0,1,4,0,0
Greece,12,5,1931,1930.1,7,27,2,1,4,1,0,0,2,1,0,0
Barbados,6,6,1931,1930.1,0,28,5,2,6,0,1,0,3,2,1,0
Ireland,1,1,1931,1930.1,0,29,1,1,0,1,0,0,1,0,0,1
Sweden,425,33,1932,1930.2,392,1,5,7,22,11,3,2,2,4,0,1
Hungary,377,15,1932,1930.2,362,2,4,5,7,8,2,1,1,3,1,1
Scotland,372,9,1932,1930.2,363,3,1,3,2,7,0,2,1,1,0,0
Austria,319,30,1932,1930.2,289,4,3,5,13,17,3,3,0,1,0,1
Argentina,279,2,1932,1930.2,277,5,1,1,2,0,1,0,0,1,0,0
Belgium,219,13,1932,1930.2,206,6,3,3,7,6,1,1,2,2,0,0
Netherlands,214,9,1932,1930.2,205,7,3,2,3,6,1,2,2,0,0,0
Uruguay,205,2,1932,1930.2,203,8,2,1,2,0,1,0,1,1,0,0
Wales,198,9,1932,1930.2,189,9,2,1,4,5,1,1,0,0,1,0
Denmark,191,10,1932,1930.2,181,10,2,2,6,4,1,1,1,1,0,0
England,181,8,1932,1930.2,173,11,3,1,8,0,3,0,0,0,0,1
Norway,161,10,1932,1930.2,151,12,3,1,6,4,2,1,1,0,0,0
Italy,155,12,1932,1930.2,143,13,2,4,7,5,2,1,0,2,0,1
Germany,152,11,1932,1930.2,141,14,3,2,6,5,2,1,1,1,0,0
Switzerland,150,14,1932,1930.2,136,15,4,3,13,1,3,0,0,3,1,0
France,148,15,1932,1930.2,133,16,2,4,2,13,0,1,2,2,0,1
Northern Ireland,147,1,1932,1930.2,146,17,1,2,0,1,0,0,1,2,0,0
Finland,129,8,1932,1930.2,121,18,3,2,6,2,1,0,2,2,0,0
Czech Republic,125,8,1932,1930.2,117,19,3,3,4,4,1,1,1,2,1,0
Estonia,89,5,1932,1930.2,84,20,3,3,5,0,1,0,2,3,0,0
Latvia,70,11,1932,1930.2,59,21,4,4,7,4,3,1,0,3,1,0
Poland,70,9,1932,1930.2,61,22,2,1,4,5,2,1,0,0,0,0
Romania,62,9,1932,1930.2,53,23,2,2,6,3,1,1,1,1,0,0
Bulgaria,39,14,1932,1930.2,25,24,3,3,7,7,2,2,1,0,0,1
Lithuania,23,9,1932,1930.2,14,25,3,4,4,5,2,1,1,3,0,0
Greece,15,3,1932,1930.2,12,26,3,1,3,0,0,0,2,1,1,0
Guyana,5,5,1932,1930.2,0,27,2,2,2,3,1,1,1,0,0,1
Sweden,444,19,1933,1930.3,425,1,4,3,15,4,3,2,1,0,0,1
Hungary,389,12,1933,1930.3,377,2,4,4,6,6,2,1,1,2,1,1
Scotland,379,7,1933,1930.3,372,3,3,1,5,2,1,0,1,1,1,0
Austria,337,18,1933,1930.3,319,4,3,5,7,11,1,2,1,0,1,3
Argentina,285,6,1933,1930.3,279,5,1,2,4,2,1,1,0,1,0,0
Belgium,232,13,1933,1930.3,219,6,3,6,5,8,0,2,2,3,1,1
Netherlands,219,5,1933,1930.3,214,7,4,1,2,3,0,1,4,0,0,0
Uruguay,208,3,1933,1930.3,205,8,2,1,2,1,1,0,1,1,0,0
Wales,205,7,1933,1930.3,198,9,1,3,3,4,1,1,0,0,0,2
Denmark,200,9,1933,1930.3,191,10,2,2,4,5,1,1,0,0,1,1
England,195,14,1933,1930.3,181,11,2,4,5,9,1,2,1,1,0,1
Italy,173,18,1933,1930.3,155,12,4,3,11,7,3,3,0,0,1,0
Norway,170,9,1933,1930.3,161,13,1,3,0,9,0,1,1,0,0,2
Germany,169,17,1933,1930.3,152,14,4,2,14,3,2,1,0,1,2,0
Switzerland,159,9,1933,1930.3,150,15,5,3,5,4,0,1,3,2,2,0
France,157,9,1933,1930.3,148,16,4,3,5,4,2,0,1,2,1,1
Northern Ireland,150,3,1933,1930.3,147,17,2,1,1,2,0,1,1,0,1,0
Finland,141,12,1933,1930.3,129,18,3,2,12,0,2,0,1,2,0,0
Czech Republic,136,11,1933,1930.3,125,19,2,4,7,4,1,2,0,2,1,0
Estonia,102,13,1933,1930.3,89,20,3,5,4,9,2,1,1,3,0,1
Latvia,83,13,1933,1930.3,70,21,3,3,9,4,2,1,0,1,1,1
Poland,71,1,1933,1930.3,70,22,2,1,1,0,0,0,2,1,0,0
Romania,71,9,1933,1930.3,62,23,1,1,7,2,1,0,0,0,0,1
Spain,50,16,1933,1930.3,34,24,2,1,16,0,2,0,0,1,0,0
Bulgaria,41,2,1933,1930.3,39,25,1,2,2,0,1,0,0,2,0,0
Lithuania,31,8,1933,1930.3,23,26,4,3,3,5,0,0,2,3,2,0
Portugal,22,1,1933,1930.3,21,27,1,1,1,0,1,0,0,1,0,0
Barbados,13,7,1933,1930.3,6,28,2,3,2,5,0,0,2,3,0,0
Sweden,467,23,1934,1930.4,444,1,3,4,10,13,2,2,0,2,1,0
Hungary,414,25,1934,1930.4,389,2,2,8,5,20,2,3,0,4,0,1
Scotland,383,4,1934,1930.4,379,3,1,2,3,1,1,0,0,2,0,0
Austria,368,31,1934,1930.4,337,4,7,4,23,8,5,2,1,2,1,0
Argentina,290,5,1934,1930.4,285,5,2,1,3,2,1,0,1,0,0,1
Netherlands,247,28,1934,1930.4,219,6,4,2,20,8,2,2,2,0,0,0
Belgium,245,13,1934,1930.4,232,7,3,2,6,7,0,0,3,1,0,1
Denmark,211,11,1934,1930.4,200,8,3,2,9,2,1,0,2,2,0,0
Uruguay,210,2,1934,1930.4,208,9,1,1,2,0,0,0,0,1,1,0
England,207,12,1934,1930.4,195,10,2,3,6,6,2,1,0,2,0,0
Wales,207,2,1934,1930.4,205,11,1,1,0,2,0,0,1,1,0,0
Germany,202,33,1934,1930.4,169,12,2,6,5,28,2,5,0,1,0,0
Italy,197,24,1934,1930.4,173,13,8,1,22,2,6,0,1,1,1,0
Norway,180,10,1934,1930.4,170,14,2,1,7,3,2,0,0,0,0,1
France,174,17,1934,1930.4,157,15,2,4,1,16,0,3,2,1,0,0
Switzerland,171,12,1934,1930.4,159,16,3,4,6,6,0,2,2,2,1,0
Czech Republic,155,19,1934,1930.4,136,17,5,4,12,7,4,1,0,1,1,2
Finland,152,11,1934,1930.4,141,18,2,4,7,4,2,0,0,2,0,2
Estonia,104,2,1934,1930.4,102,19,1,1,1,1,0,0,0,0,1,1
Latvia,88,5,1934,1930.4,83,20,3,2,4,1,0,0,2,2,1,0
Poland,86,15,1934,1930.4,71,21,2,3,5,10,0,1,1,2,1,0
Spain,65,15,1934,1930.4,50,22,1,4,9,6,1,2,0,1,0,1
Bulgaria,45,4,1934,1930.4,41,23,2,1,3,1,0,0,2,1,0,0
Lithuania,38,7,1934,1930.4,31,24,3,1,4,3,2,1,0,0,1,0
China,31,8,1934,1930.4,23,25,2,1,6,2,2,1,0,0,0,0
Egypt,24,13,1934,1930.4,11,26,2,1,9,4,1,1,1,0,0,0
Portugal,23,1,1934,1930.4,22,27,1,1,1,0,0,0,1,1,0,0
Greece,17,2,1934,1930.4,15,28,1,1,2,0,0,0,0,1,1,0
Ireland,9,8,1934,1930.4,1,29,2,1,6,2,0,0,1,1,1,0
Suriname,9,9,1934,1930.4,0,30,1,4,3,6,0,0,0,2,1,2
Japan,7,4,1934,1930.4,3,31,1,1,1,3,0,0,1,1,0,0
Israel,2,2,1934,1930.4,0,32,1,1,1,1,0,0,1,1,0,0
Sweden,490,23,1935,1930.5,467,1,4,5,15,8,3,3,0,2,1,0
Hungary,435,21,1935,1930.5,414,2,3,4,13,8,3,0,0,2,0,2
Scotland,397,14,1935,1930.5,383,3,2,3,4,10,2,2,0,0,0,1
Austria,380,12,1935,1930.5,368,4,3,3,9,3,1,0,1,2,1,1
Argentina,302,12,1935,1930.5,290,5,3,2,7,5,2,1,1,0,0,1
Netherlands,263,16,1935,1930.5,247,6,4,2,9,7,2,2,2,0,0,0
Belgium,256,11,1935,1930.5,245,7,5,1,9,2,1,0,2,1,2,0
Germany,250,48,1935,1930.5,202,8,10,7,33,15,9,4,1,2,0,1
Denmark,218,7,1935,1930.5,211,9,2,2,6,1,2,0,0,2,0,0
Uruguay,217,7,1935,1930.5,210,10,1,4,1,6,0,3,0,1,1,0
England,216,9,1935,1930.5,207,11,2,3,5,4,2,2,0,1,0,0
Italy,204,7,1935,1930.5,197,12,2,2,4,3,1,1,0,1,1,0
Norway,186,6,1935,1930.5,180,13,2,3,1,5,0,1,1,2,1,0
Switzerland,186,15,1935,1930.5,171,14,4,4,11,4,4,0,0,3,0,1
France,182,8,1935,1930.5,174,15,3,4,5,3,2,0,1,3,0,1
Czech Republic,161,6,1935,1930.5,155,16,3,2,5,1,2,0,0,2,1,0
Finland,158,6,1935,1930.5,152,17,1,4,1,5,0,0,1,2,0,2
Northern Ireland,154,4,1935,1930.5,150,18,1,3,1,3,0,0,1,3,0,0
Estonia,114,10,1935,1930.5,104,19,5,3,7,3,0,0,2,1,3,2
Latvia,103,15,1935,1930.5,88,20,4,4,9,6,1,0,1,1,2,3
Poland,93,7,1935,1930.5,86,21,2,3,4,3,1,0,0,3,1,0
Romania,80,9,1935,1930.5,71,22,1,4,4,5,1,0,0,3,0,1
Spain,72,7,1935,1930.5,65,23,1,2,2,5,1,1,0,0,0,1
Bulgaria,58,13,1935,1930.5,45,24,2,2,9,4,2,1,0,1,0,0
Lithuania,49,11,1935,1930.5,38,25,2,4,4,7,0,1,0,1,2,2
Greece,22,5,1935,1930.5,17,26,2,1,3,2,0,0,1,1,1,0
Chile,15,2,1935,1930.5,13,27,1,2,1,1,0,0,1,2,0,0
Curaçao,13,13,1935,1930.5,0,28,4,3,10,3,4,1,0,2,0,0
Ireland,13,4,1935,1930.5,9,29,1,2,3,1,0,0,1,2,0,0
Uganda,13,8,1935,1930.5,5,30,1,1,5,3,1,1,0,0,0,0
Kenya,2,2,1935,1930.5,0,31,1,1,1,1,0,0,1,1,0,0
Sweden,505,15,1936,1930.6,490,1,3,2,10,5,2,1,1,1,0,0
Hungary,461,26,1936,1930.6,435,2,4,5,12,14,2,3,1,2,1,0
Scotland,404,7,1936,1930.6,397,3,2,2,3,4,1,1,1,0,0,1
Austria,402,22,1936,1930.6,380,4,3,5,6,16,1,3,1,1,1,1
Argentina,306,4,1936,1930.6,302,5,2,1,3,1,2,0,0,1,0,0
Netherlands,281,18,1936,1930.6,263,6,2,2,11,7,1,1,0,0,1,1
Germany,271,21,1936,1930.6,250,7,2,7,9,12,1,3,0,3,1,1
Belgium,261,5,1936,1930.6,256,8,3,3,4,1,1,0,1,2,1,1
Denmark,231,13,1936,1930.6,218,9,2,2,6,7,2,1,0,0,0,1
England,231,15,1936,1930.6,216,10,4,3,11,4,2,0,1,3,1,0
Uruguay,219,2,1936,1930.6,217,11,1,1,2,0,1,0,0,1,0,0
Italy,218,14,1936,1930.6,204,12,3,3,8,6,2,2,0,0,1,1
Wales,215,8,1936,1930.6,207,13,1,3,2,6,1,2,0,1,0,0
Norway,197,11,1936,1930.6,186,14,3,3,4,7,0,1,2,1,1,1
Switzerland,195,9,1936,1930.6,186,15,4,4,3,6,0,1,3,3,1,0
Czech Republic,171,10,1936,1930.6,161,16,2,3,6,4,1,1,1,1,0,1
Finland,164,6,1936,1930.6,158,17,2,2,2,4,0,1,2,0,0,1
Northern Ireland,159,5,1936,1930.6,154,18,2,1,4,1,1,0,1,1,0,0
Estonia,122,8,1936,1930.6,114,19,3,2,7,1,1,0,1,2,1,0
Latvia,119,16,1936,1930.6,103,20,3,2,7,9,2,2,0,0,1,0
Poland,100,7,1936,1930.6,93,21,1,3,1,6,0,1,0,1,1,1
Spain,79,7,1936,1930.6,72,22,2,1,5,2,0,1,2,0,0,0
Bulgaria,64,6,1936,1930.6,58,23,1,1,5,1,1,0,0,1,0,0
Lithuania,54,5,1936,1930.6,49,24,2,2,3,2,1,0,1,2,0,0
Ireland,29,16,1936,1930.6,13,25,3,2,8,8,2,1,1,0,0,1
Curaçao,17,4,1936,1930.6,13,26,1,1,4,0,1,0,0,1,0,0
Trinidad and Tobago,13,8,1936,1930.6,5,27,1,3,3,5,1,2,0,1,0,0
Luxembourg,3,3,1936,1930.6,0,28,1,1,1,2,0,0,1,1,0,0
Sweden,522,17,1937,1930.7,505,1,4,4,12,5,2,0,2,3,0,1
Hungary,480,19,1937,1930.7,461,2,3,3,12,7,2,2,0,1,1,0
Austria,417,15,1937,1930.7,402,3,5,3,10,5,3,1,1,1,1,1
Scotland,415,11,1937,1930.7,404,4,3,2,9,2,2,0,0,1,1,1
Argentina,326,20,1937,1930.7,306,5,6,1,17,3,5,1,1,0,0,0
Germany,307,36,1937,1930.7,271,6,7,4,27,9,6,4,0,0,1,0
Netherlands,293,12,1937,1930.7,281,7,4,2,9,3,3,0,1,1,0,1
Belgium,268,7,1937,1930.7,261,8,3,3,6,1,2,0,1,3,0,0
England,262,31,1937,1930.7,231,9,2,5,7,24,2,4,0,1,0,0
Denmark,241,10,1937,1930.7,231,10,2,3,7,3,2,1,0,2,0,0
Uruguay,231,12,1937,1930.7,219,11,1,6,0,12,0,2,1,4,0,0
Italy,226,8,1937,1930.7,218,12,1,5,2,6,1,2,0,1,0,2
Wales,222,7,1937,1930.7,215,13,2,1,6,1,2,0,0,1,0,0
Norway,210,13,1937,1930.7,197,14,4,4,7,6,2,1,2,2,0,1
Switzerland,208,13,1937,1930.7,195,15,4,6,3,10,0,1,3,5,1,0
Czech Republic,191,20,1937,1930.7,171,16,4,5,11,9,3,0,1,3,0,2
France,189,7,1937,1930.7,182,17,4,3,3,4,1,1,2,2,1,0
Finland,165,1,1937,1930.7,164,18,4,2,0,1,0,0,4,2,0,0
Northern Ireland,162,3,1937,1930.7,159,19,1,2,1,2,0,0,1,1,0,1
Latvia,137,18,1937,1930.7,119,20,3,6,8,10,2,2,1,3,0,1
Estonia,136,14,1937,1930.7,122,21,3,6,3,11,1,3,1,3,1,0
Poland,113,13,1937,1930.7,100,22,4,1,10,3,3,0,1,0,0,1
Romania,90,10,1937,1930.7,80,23,3,2,5,5,1,1,0,1,2,0
Paraguay,62,8,1937,1930.7,54,24,2,3,4,4,1,1,1,2,0,0
Brazil,59,14,1937,1930.7,45,25,3,2,14,0,3,0,0,2,0,0
Lithuania,58,4,1937,1930.7,54,26,3,1,2,2,0,0,3,1,0,0
Ireland,37,8,1937,1930.7,29,27,1,3,3,5,0,2,0,1,1,0
Chile,26,11,1937,1930.7,15,28,3,1,7,4,1,0,1,1,1,0
Guyana,7,2,1937,1930.7,5,29,2,1,2,0,0,0,2,1,0,0
Peru,7,5,1937,1930.7,2,30,1,3,2,3,0,1,1,1,0,1
Luxembourg,5,2,1937,1930.7,3,31,1,1,2,0,0,0,1,1,0,0
Sweden,548,26,1938,1930.8,522,1,4,6,9,17,1,3,2,3,1,0
Hungary,514,34,1938,1930.8,480,2,5,4,26,8,4,1,1,2,0,1
Scotland,427,12,1938,1930.8,415,3,2,3,6,6,2,3,0,0,0,0
Argentina,330,4,1938,1930.8,326,4,1,1,1,3,1,1,0,0,0,0
Germany,326,19,1938,1930.8,307,5,8,1,15,4,2,1,2,0,4,0
Netherlands,313,20,1938,1930.8,293,6,3,3,17,3,2,0,1,1,0,2
England,286,24,1938,1930.8,262,7,3,4,11,13,2,2,1,2,0,0
Belgium,282,14,1938,1930.8,268,8,1,6,1,13,0,2,0,4,1,0
Italy,246,20,1938,1930.8,226,9,4,3,11,9,4,3,0,0,0,0
Denmark,245,4,1938,1930.8,241,10,2,2,2,2,0,0,1,1,1,1
Uruguay,233,2,1938,1930.8,231,11,1,1,2,0,0,0,1,1,0,0
Norway,229,19,1938,1930.8,210,12,4,4,13,6,3,1,0,2,1,1
Wales,228,6,1938,1930.8,222,13,1,2,4,2,1,0,0,2,0,0
Switzerland,226,18,1938,1930.8,208,14,6,6,12,6,4,1,1,3,1,2
Czech Republic,217,26,1938,1930.8,191,15,4,5,17,9,3,1,0,3,1,1
France,206,17,1938,1930.8,189,16,5,1,17,0,3,0,2,1,0,0
Finland,175,10,1938,1930.8,165,17,3,3,7,3,2,1,1,2,0,0
Northern Ireland,163,1,1938,1930.8,162,18,2,1,1,0,1,0,1,1,0,0
Latvia,150,13,1938,1930.8,137,19,4,3,7,6,3,1,0,0,1,2
Estonia,143,7,1938,1930.8,136,20,4,2,5,2,1,1,2,1,1,0
Poland,133,20,1938,1930.8,113,21,2,5,8,12,1,0,0,4,1,1
Romania,97,7,1938,1930.8,90,22,1,3,1,6,0,0,1,2,0,1
Lithuania,61,3,1938,1930.8,58,23,1,4,0,3,0,0,1,3,0,1
Ireland,46,9,1938,1930.8,37,24,2,2,7,2,2,0,0,1,0,1
Portugal,30,7,1938,1930.8,23,25,2,3,5,2,2,0,0,2,0,1
Greece,27,5,1938,1930.8,22,26,1,2,1,4,1,1,0,1,0,0
Peru,22,15,1938,1930.8,7,27,1,2,2,13,1,2,0,0,0,0
Trinidad and Tobago,21,8,1938,1930.8,13,28,1,5,1,7,0,3,1,1,0,1
Suriname,17,8,1938,1930.8,9,29,2,6,3,5,1,1,1,5,0,0
Bolivia,13,8,1938,1930.8,5,30,3,1,6,2,2,1,0,0,1,0
Ecuador,10,10,1938,1930.8,0,31,2,3,6,4,1,1,1,1,0,1
Luxembourg,8,3,1938,1930.8,5,32,2,1,2,1,0,0,2,1,0,0
Israel,3,1,1938,1930.8,2,33,1,1,1,0,0,0,1,1,0,0
Sweden,570,22,1939,1930.9,548,1,4,2,19,3,4,1,0,1,0,0
Hungary,531,17,1939,1930.9,514,2,3,5,8,9,1,0,1,3,1,2
Germany,362,36,1939,1930.9,326,3,4,10,13,23,2,5,0,4,2,1
Netherlands,324,11,1939,1930.9,313,4,2,2,6,5,2,0,0,2,0,0
Belgium,295,13,1939,1930.9,282,5,4,2,8,5,1,0,3,1,0,1
Denmark,269,24,1939,1930.9,245,6,5,1,23,1,4,0,1,1,0,0
Italy,261,15,1939,1930.9,246,7,2,5,5,10,1,3,0,2,1,0
Switzerland,241,15,1939,1930.9,226,8,3,3,8,7,3,2,0,0,0,1
Norway,240,11,1939,1930.9,229,9,3,4,3,8,1,1,2,3,0,0
Wales,232,4,1939,1930.9,228,10,1,1,3,1,1,0,0,1,0,0
Czech Republic,226,9,1939,1930.9,217,11,1,1,5,4,0,0,0,0,1,1
France,217,11,1939,1930.9,206,12,3,1,8,3,2,1,0,0,1,0
Finland,184,9,1939,1930.9,175,13,4,3,7,2,1,0,3,3,0,0
Latvia,156,6,1939,1930.9,150,14,1,3,3,3,0,1,0,2,1,0
Estonia,148,5,1939,1930.9,143,15,2,2,0,5,0,0,2,1,0,1
Poland,141,8,1939,1930.9,133,16,3,1,8,0,1,0,0,1,2,0
Paraguay,74,12,1939,1930.9,62,17,3,4,3,9,0,2,2,2,1,0
Ireland,51,5,1939,1930.9,46,18,1,2,2,3,0,0,0,0,1,2
Chile,38,12,1939,1930.9,26,19,4,1,11,1,2,0,2,1,0,0
Ecuador,14,4,1939,1930.9,10,20,2,2,1,3,0,0,2,2,0,0
Slovakia,3,3,1939,1930.9,0,21,1,1,2,1,1,0,0,1,0,0
Panama,1,1,1939,1930.9,0,22,1,3,0,1,0,0,1,2,0,1
Sweden,582,12,1940,1940,570,1,2,2,6,6,1,1,0,0,1,1
Hungary,543,12,1940,1940,531,2,4,3,8,4,3,0,0,0,1,3
Germany,399,37,1940,1940,362,3,5,3,32,5,4,1,0,1,1,1
Argentina,367,37,1940,1940,330,4,8,3,32,5,7,1,1,1,0,1
Netherlands,333,9,1940,1940,324,5,2,1,8,1,1,0,1,1,0,0
Belgium,304,9,1940,1940,295,6,1,1,7,2,1,0,0,1,0,0
Denmark,273,4,1940,1940,269,7,1,2,3,1,0,0,0,1,1,1
Uruguay,244,11,1940,1940,233,8,2,3,6,5,2,1,0,1,0,1
Switzerland,242,1,1940,1940,241,9,1,3,0,1,0,0,1,2,0,1
Finland,186,2,1940,1940,184,10,1,2,2,0,0,0,1,2,0,0
Latvia,161,5,1940,1940,156,11,1,2,1,4,1,0,0,2,0,0
Estonia,151,3,1940,1940,148,12,2,1,3,0,1,0,0,1,1,0
Brazil,70,11,1940,1940,59,13,4,3,6,5,0,1,2,2,2,0
Bulgaria,68,4,1940,1940,64,14,1,1,1,3,0,0,1,1,0,0
Lithuania,68,7,1940,1940,61,15,2,2,6,1,2,0,0,1,0,1
Slovakia,7,4,1940,1940,3,16,1,1,0,4,0,1,1,0,0,0
Croatia,6,6,1940,1940,0,17,2,2,5,1,1,1,0,1,1,0
Sweden,589,7,1941,1940.1,582,1,2,1,6,1,1,0,0,1,1,0
Germany,433,34,1941,1940.1,399,2,5,4,21,13,4,2,0,2,1,0
Argentina,389,22,1941,1940.1,367,3,3,6,9,13,3,4,0,0,0,2
Denmark,278,5,1941,1940.1,273,4,1,2,2,3,1,0,0,0,0,2
Switzerland,249,7,1941,1940.1,242,5,2,2,3,4,1,0,1,2,0,0
Spain,89,10,1941,1940.1,79,6,2,1,8,2,2,0,0,0,0,1
Curaçao,41,24,1941,1940.1,17,7,5,3,20,4,3,0,0,1,2,2
Portugal,33,3,1941,1940.1,30,8,1,1,2,1,0,0,0,1,1,0
Peru,29,7,1941,1940.1,22,9,4,3,2,5,0,1,2,2,2,0
Ecuador,15,1,1941,1940.1,14,10,2,2,0,1,0,0,2,2,0,0
El Salvador,15,15,1941,1940.1,0,11,2,2,12,3,2,0,0,1,0,1
Croatia,12,6,1941,1940.1,6,12,1,1,5,1,1,0,0,1,0,0
Martinique,7,7,1941,1940.1,0,13,1,1,5,2,1,1,0,0,0,0
Nicaragua,5,5,1941,1940.1,0,14,1,3,2,3,0,0,1,3,0,0
Aruba,3,3,1941,1940.1,0,15,2,2,2,1,0,0,0,2,2,0
India,3,3,1941,1940.1,0,16,1,1,0,3,0,1,1,0,0,0
Guadeloupe,1,1,1941,1940.1,0,17,1,1,1,0,0,0,1,1,0,0
Sweden,598,9,1942,1940.2,589,1,1,3,2,7,1,2,0,1,0,0
Germany,467,34,1942,1940.2,433,2,5,4,16,18,2,4,2,0,1,0
Argentina,415,26,1942,1940.2,389,3,6,2,25,1,5,0,0,1,1,1
Denmark,279,1,1942,1940.2,278,4,1,1,0,1,0,0,1,1,0,0
Uruguay,267,23,1942,1940.2,244,5,7,1,22,1,6,0,0,1,1,0
Switzerland,259,10,1942,1940.2,249,6,2,4,6,4,1,2,1,2,0,0
France,217,0,1942,1940.2,217,7,1,1,0,0,0,0,1,1,0,0
Latvia,173,12,1942,1940.2,161,8,1,1,4,8,1,1,0,0,0,0
Estonia,152,1,1942,1940.2,151,9,1,1,1,0,0,0,1,1,0,0
Romania,99,2,1942,1940.2,97,10,1,2,2,0,0,0,0,2,1,0
Spain,94,5,1942,1940.2,89,11,1,2,4,1,1,0,0,1,0,1
Brazil,85,15,1942,1940.2,70,12,4,2,14,1,3,0,0,2,1,0
Paraguay,85,11,1942,1940.2,74,13,1,5,1,10,0,2,0,2,1,1
Chile,42,4,1942,1940.2,38,14,3,3,2,2,1,0,1,2,1,1
Japan,25,18,1942,1940.2,7,15,1,1,12,6,1,1,0,0,0,0
Croatia,24,12,1942,1940.2,12,16,1,5,6,6,1,1,0,2,0,2
Ecuador,19,4,1942,1940.2,15,17,2,4,2,2,0,0,2,4,0,0
Slovakia,12,5,1942,1940.2,7,18,3,1,4,1,1,0,2,1,0,0
Sweden,611,13,1943,1940.3,598,1,2,3,3,10,1,1,1,1,0,1
Hungary,558,15,1943,1940.3,543,2,1,4,2,13,0,4,1,0,0,0
Argentina,425,10,1943,1940.3,415,3,1,3,3,7,0,2,0,1,1,0
Uruguay,270,3,1943,1940.3,267,4,1,1,0,3,0,0,1,0,0,1
Switzerland,261,2,1943,1940.3,259,5,2,1,2,0,1,0,1,1,0,0
Curaçao,49,8,1943,1940.3,41,6,2,2,5,3,0,1,0,0,2,1
Costa Rica,33,20,1943,1940.3,13,7,2,4,9,11,1,2,1,2,0,0
Guatemala,31,21,1943,1940.3,10,8,2,4,10,11,2,2,0,1,0,1
Croatia,25,1,1943,1940.3,24,9,1,1,1,0,1,0,0,1,0,0
Nicaragua,12,7,1943,1940.3,5,10,2,4,3,4,0,0,2,4,0,0
Aruba,10,7,1943,1940.3,3,11,2,2,2,5,0,0,1,0,1,2
Curaçao,75,26,1944,1940.4,49,1,5,4,15,11,2,4,2,0,1,0
Trinidad and Tobago,48,27,1944,1940.4,21,2,6,3,21,6,5,1,0,0,1,2
Aruba,25,15,1944,1940.4,10,3,4,5,4,11,0,3,3,2,1,0
Barbados,17,4,1944,1940.4,13,4,5,3,3,1,0,0,3,3,2,0
Haiti,6,1,1944,1940.4,5,5,1,2,0,1,0,0,1,1,0,1
Sweden,644,33,1945,1940.5,611,1,4,3,23,10,4,2,0,1,0,0
Argentina,476,51,1945,1940.5,425,2,8,7,37,14,8,2,0,3,0,2
Austria,423,6,1945,1940.5,417,3,1,2,4,2,1,0,0,2,0,0
Belgium,307,3,1945,1940.5,304,4,1,1,2,1,1,0,0,1,0,0
Denmark,293,14,1945,1940.5,279,5,2,3,7,7,1,1,1,2,0,0
England,289,3,1945,1940.5,286,6,1,1,2,1,0,0,0,1,1,0
Uruguay,288,18,1945,1940.5,270,7,1,7,2,16,0,3,0,4,1,0
Norway,243,3,1945,1940.5,240,8,1,2,1,2,0,0,1,2,0,0
Finland,189,3,1945,1940.5,186,9,1,1,1,2,0,0,1,1,0,0
Estonia,156,4,1945,1940.5,152,10,1,1,1,3,0,1,1,0,0,0
Brazil,116,31,1945,1940.5,85,11,6,3,27,4,5,2,1,1,0,0
Spain,100,6,1945,1940.5,94,12,1,1,4,2,1,0,0,0,0,1
Paraguay,96,11,1945,1940.5,85,13,2,2,6,5,1,0,1,2,0,0
Lithuania,79,11,1945,1940.5,68,14,1,2,2,9,0,2,1,0,0,0
Portugal,37,4,1945,1940.5,33,15,1,2,2,2,0,0,0,2,1,0
Ecuador,28,9,1945,1940.5,19,16,1,5,1,8,0,0,1,4,0,1
Bolivia,16,3,1945,1940.5,13,17,4,2,3,0,0,0,2,2,2,0
Colombia,7,7,1945,1940.5,0,18,2,4,3,4,1,0,1,3,0,1
Sweden,665,21,1946,1940.6,644,1,2,3,10,11,1,2,0,1,1,0
Hungary,569,11,1946,1940.6,558,2,1,2,2,9,1,1,0,1,0,0
Scotland,433,6,1946,1940.6,427,3,3,1,5,1,1,0,0,1,2,0
Austria,432,9,1946,1940.6,423,4,2,4,6,3,1,0,1,4,0,0
Netherlands,349,16,1946,1940.6,333,5,1,3,6,10,1,1,0,1,0,1
Belgium,321,14,1946,1940.6,307,6,2,3,9,5,1,0,0,2,1,1
Denmark,317,24,1946,1940.6,293,7,3,4,12,12,3,2,0,1,0,1
England,315,26,1946,1940.6,289,8,4,3,17,9,4,2,0,1,0,0
Uruguay,303,15,1946,1940.6,288,9,1,5,4,11,1,2,0,3,0,0
Switzerland,268,7,1946,1940.6,261,10,1,4,1,6,1,0,0,4,0,0
Norway,260,17,1946,1940.6,243,11,3,3,14,3,2,0,1,3,0,0
Wales,235,3,1946,1940.6,232,12,1,1,3,0,1,0,0,1,0,0
Czech Republic,233,7,1946,1940.6,226,13,1,2,3,4,1,1,0,1,0,0
France,226,9,1946,1940.6,217,14,3,1,8,1,3,0,0,1,0,0
Finland,191,2,1946,1940.6,189,15,2,1,2,0,0,0,2,1,0,0
Northern Ireland,165,2,1946,1940.6,163,16,1,1,2,0,0,0,1,0,0,1
Brazil,132,16,1946,1940.6,116,17,3,3,10,6,2,1,0,2,1,0
Paraguay,104,8,1946,1940.6,96,18,1,4,2,6,1,1,0,2,0,1
Curaçao,88,13,1946,1940.6,75,19,2,2,8,5,2,1,0,1,0,0
Bulgaria,71,3,1946,1940.6,68,20,1,1,2,1,0,0,0,1,1,0
Ireland,53,2,1946,1940.6,51,21,1,2,0,2,0,1,1,1,0,0
Guatemala,51,20,1946,1940.6,31,22,1,4,7,13,1,2,0,1,0,1
Chile,50,8,1946,1940.6,42,23,2,3,2,6,1,1,1,2,0,0
Aruba,37,12,1946,1940.6,25,24,3,1,11,1,2,0,1,1,0,0
El Salvador,35,20,1946,1940.6,15,25,6,1,20,0,3,0,2,1,1,0
Bolivia,20,4,1946,1940.6,16,26,4,1,3,1,0,0,4,1,0,0
Honduras,17,17,1946,1940.6,0,27,2,3,15,2,2,0,0,3,0,0
Luxembourg,15,7,1946,1940.6,8,28,3,1,7,0,1,0,2,1,0,0
Panama,12,11,1946,1940.6,1,29,3,4,4,7,1,1,1,2,1,1
Sweden,698,33,1947,1940.7,665,1,4,3,22,11,4,2,0,1,0,0
Hungary,594,25,1947,1940.7,569,2,3,3,17,8,3,1,0,2,0,0
Argentina,504,28,1947,1940.7,476,3,6,1,26,2,5,1,0,0,1,0
Austria,445,13,1947,1940.7,432,4,2,2,9,4,2,0,0,2,0,0
Scotland,442,9,1947,1940.7,433,5,1,4,1,8,0,1,1,2,0,1
Netherlands,359,10,1947,1940.7,349,6,2,2,8,2,2,1,0,1,0,0
England,343,28,1947,1940.7,315,7,4,4,10,18,2,3,0,1,2,0
Denmark,330,13,1947,1940.7,317,8,3,2,7,6,1,1,1,1,1,0
Belgium,329,8,1947,1940.7,321,9,3,3,5,3,1,0,2,3,0,0
Uruguay,326,23,1947,1940.7,303,10,1,8,0,23,0,5,0,3,1,0
Switzerland,280,12,1947,1940.7,268,11,3,3,6,6,2,0,1,2,0,1
Norway,277,17,1947,1940.7,260,12,3,4,7,10,1,2,2,1,0,1
Italy,273,12,1947,1940.7,261,13,3,1,11,1,3,0,0,1,0,0
Czech Republic,251,18,1947,1940.7,233,14,2,3,9,9,2,1,0,1,0,1
France,241,15,1947,1940.7,226,15,3,3,9,6,3,2,0,1,0,0
Wales,238,3,1947,1940.7,235,16,1,2,0,3,0,1,1,1,0,0
Finland,197,6,1947,1940.7,191,17,3,2,5,1,0,0,2,2,1,0
Latvia,179,6,1947,1940.7,173,18,1,1,3,3,1,1,0,0,0,0
Northern Ireland,171,6,1947,1940.7,165,19,2,1,4,2,2,0,0,0,0,1
Poland,154,13,1947,1940.7,141,20,1,5,1,12,0,1,1,3,0,1
Brazil,135,3,1947,1940.7,132,21,1,1,3,0,1,0,0,0,0,1
Paraguay,120,16,1947,1940.7,104,22,2,5,6,10,1,4,0,1,1,0
Romania,110,11,1947,1940.7,99,23,3,3,2,9,0,3,2,0,1,0
Lithuania,81,2,1947,1940.7,79,24,2,1,0,2,0,0,1,1,1,0
Bulgaria,75,4,1947,1940.7,71,25,2,1,4,0,1,0,1,1,0,0
Trinidad and Tobago,67,19,1947,1940.7,48,26,4,7,10,9,3,2,1,4,0,1
Chile,64,14,1947,1940.7,50,27,4,3,6,8,2,2,2,0,0,1
Portugal,47,10,1947,1940.7,37,28,4,2,8,2,1,1,2,1,1,0
Peru,41,12,1947,1940.7,29,29,1,6,0,12,0,2,1,2,0,2
Bolivia,26,6,1947,1940.7,20,30,5,2,4,2,0,0,4,1,1,1
Mexico,23,8,1947,1940.7,15,31,1,1,5,3,1,1,0,0,0,0
Guyana,11,4,1947,1940.7,7,32,2,5,2,2,1,1,0,3,1,1
Colombia,9,2,1947,1940.7,7,33,3,4,1,1,0,0,3,2,0,2
Jamaica,4,4,1947,1940.7,0,34,5,4,4,0,2,0,2,3,1,1
Mauritius,4,4,1947,1940.7,0,35,1,1,2,2,1,1,0,0,0,0
Albania,0,0,1947,1940.7,0,36,1,2,0,0,0,0,1,2,0,0
Sweden,710,12,1948,1940.8,698,1,2,4,4,8,2,1,0,2,0,1
Hungary,627,33,1948,1940.8,594,2,4,5,20,13,4,2,0,2,0,1
Austria,458,13,1948,1940.8,445,3,3,4,8,5,3,1,0,3,0,0
Scotland,451,9,1948,1940.8,442,4,3,3,5,4,2,1,1,2,0,0
Netherlands,366,7,1948,1940.8,359,5,2,3,3,4,1,1,0,0,1,2
England,362,19,1948,1940.8,343,6,2,4,7,12,2,3,0,0,0,1
Denmark,342,12,1948,1940.8,330,7,3,2,9,3,1,1,1,1,1,0
Belgium,340,11,1948,1940.8,329,8,3,3,6,5,1,0,0,1,2,2
Norway,297,20,1948,1940.8,277,9,4,2,17,3,2,1,2,0,0,1
Switzerland,292,12,1948,1940.8,280,10,3,4,6,6,1,1,0,3,2,0
Italy,276,3,1948,1940.8,273,11,1,1,0,3,0,1,1,0,0,0
Czech Republic,258,7,1948,1940.8,251,12,2,5,3,4,1,0,1,4,0,1
France,254,13,1948,1940.8,241,13,3,2,7,6,1,1,1,1,1,0
Wales,241,3,1948,1940.8,238,14,2,1,3,0,1,0,1,1,0,0
Finland,199,2,1948,1940.8,197,15,2,3,2,0,0,0,1,3,1,0
Northern Ireland,180,9,1948,1940.8,171,16,2,2,7,2,1,0,1,2,0,0
Poland,161,7,1948,1940.8,154,17,4,2,6,1,2,0,1,1,1,1
Romania,116,6,1948,1940.8,110,18,4,2,6,0,2,0,2,1,0,1
Spain,107,7,1948,1940.8,100,19,2,1,4,3,2,0,0,0,0,1
Curaçao,102,14,1948,1940.8,88,20,3,5,6,8,1,1,2,2,0,2
Bulgaria,80,5,1948,1940.8,75,21,3,1,3,2,2,0,0,1,1,0
Trinidad and Tobago,77,10,1948,1940.8,67,22,3,3,8,2,2,1,0,1,1,1
Ireland,54,1,1948,1940.8,53,23,1,2,0,1,0,0,1,2,0,0
Costa Rica,51,18,1948,1940.8,33,24,3,4,8,10,3,1,0,2,0,1
Portugal,49,2,1948,1940.8,47,25,1,1,2,0,1,0,0,1,0,0
El Salvador,41,6,1948,1940.8,35,26,3,5,2,4,1,1,2,3,0,1
Panama,31,19,1948,1940.8,12,27,2,5,3,16,1,3,1,2,0,0
Greece,29,2,1948,1940.8,27,28,1,1,1,1,0,0,1,1,0,0
Suriname,24,7,1948,1940.8,17,29,4,1,4,3,2,0,1,1,1,0
Martinique,22,15,1948,1940.8,7,30,2,2,9,6,2,1,0,1,0,0
Turkey,20,6,1948,1940.8,14,31,2,2,2,4,1,1,1,0,0,1
USA,9,3,1948,1940.8,6,32,1,2,3,0,1,0,0,2,0,0
Madagascar,3,3,1948,1940.8,0,33,1,1,2,1,1,0,0,1,0,0
Albania,1,1,1948,1940.8,0,34,1,1,0,1,0,1,0,0,1,0
Dominica,0,0,1948,1940.8,0,35,1,1,0,0,0,0,1,1,0,0
Sweden,734,24,1949,1940.9,710,1,5,3,19,5,3,1,0,2,2,0
Hungary,660,33,1949,1940.9,627,2,5,3,25,8,4,1,0,1,1,1
Scotland,470,19,1949,1940.9,451,3,2,3,4,15,2,3,0,0,0,0
Austria,469,11,1949,1940.9,458,4,3,3,7,4,2,1,1,2,0,0
England,386,24,1949,1940.9,362,5,4,4,12,12,2,3,2,1,0,0
Netherlands,379,13,1949,1940.9,366,6,4,2,7,6,1,2,2,0,1,0
Denmark,356,14,1949,1940.9,342,7,4,3,9,5,2,3,2,0,0,0
Belgium,354,14,1949,1940.9,340,8,2,5,6,8,2,2,0,1,0,2
Uruguay,340,14,1949,1940.9,326,9,1,6,2,12,0,2,0,4,1,0
Switzerland,307,15,1949,1940.9,292,10,3,3,10,5,2,1,1,2,0,0
Norway,302,5,1949,1940.9,297,11,2,2,1,4,0,0,2,0,0,2
Italy,287,11,1949,1940.9,276,12,2,3,7,4,2,1,0,1,0,1
Czech Republic,272,14,1949,1940.9,258,13,5,2,13,1,3,0,1,2,1,0
France,262,8,1949,1940.9,254,14,4,2,7,1,2,0,2,2,0,0
Wales,252,11,1949,1940.9,241,15,2,5,6,5,1,1,1,4,0,0
Finland,205,6,1949,1940.9,199,16,3,3,3,3,0,1,1,2,2,0
Northern Ireland,184,4,1949,1940.9,180,17,2,1,2,2,0,0,2,1,0,0
Poland,170,9,1949,1940.9,161,18,3,3,6,3,2,0,1,3,0,0
Paraguay,141,21,1949,1940.9,120,19,2,6,4,17,1,5,1,1,0,0
Romania,125,9,1949,1940.9,116,20,2,2,3,6,1,1,0,1,1,0
Spain,119,12,1949,1940.9,107,21,2,3,2,10,0,2,1,0,1,1
Bulgaria,85,5,1949,1940.9,80,22,1,3,0,5,0,1,0,2,1,0
Chile,74,10,1949,1940.9,64,23,5,2,7,3,2,0,2,2,1,0
Ireland,64,10,1949,1940.9,54,24,5,3,6,4,2,1,3,1,0,1
Peru,61,20,1949,1940.9,41,25,1,6,4,16,1,4,0,2,0,0
Portugal,54,5,1949,1940.9,49,26,2,2,4,1,1,0,0,2,1,0
Bolivia,39,13,1949,1940.9,26,27,6,1,12,1,4,0,2,1,0,0
Ecuador,35,7,1949,1940.9,28,28,3,4,2,5,0,1,3,3,0,0
Turkey,32,12,1949,1940.9,20,29,1,3,7,5,1,2,0,1,0,0
Egypt,29,5,1949,1940.9,24,30,1,1,2,3,0,1,1,0,0,0
Martinique,24,2,1949,1940.9,22,31,1,1,2,0,1,0,0,0,0,1
Luxembourg,21,6,1949,1940.9,15,32,1,2,2,4,0,0,1,1,0,1
USA,17,8,1949,1940.9,9,33,2,3,5,3,1,0,1,2,0,1
Jamaica,15,11,1949,1940.9,4,34,3,2,6,5,2,1,1,1,0,0
Colombia,13,4,1949,1940.9,9,35,3,4,1,3,0,0,3,2,0,2
Madagascar,7,4,1949,1940.9,3,36,1,1,1,3,0,1,1,0,0,0
Cuba,6,6,1949,1940.9,0,37,4,5,3,3,0,1,2,4,2,0
Albania,4,3,1949,1940.9,1,38,1,3,1,2,0,0,1,1,0,2
Sweden,759,25,1950,1950,734,1,3,7,10,15,2,4,1,2,0,1
Hungary,690,30,1950,1950,660,2,3,3,21,9,3,1,0,1,0,1
Austria,487,18,1950,1950,469,3,4,2,14,4,3,1,0,1,1,0
Scotland,485,15,1950,1950,470,4,4,3,9,6,2,2,2,0,0,1
England,406,20,1950,1950,386,5,3,5,4,16,1,5,2,0,0,0
Belgium,377,23,1950,1950,354,6,5,2,19,4,4,0,1,1,0,1
Denmark,364,8,1950,1950,356,7,2,3,5,3,1,1,1,2,0,0
Switzerland,326,19,1950,1950,307,8,2,5,11,8,2,1,0,2,0,2
Norway,315,13,1950,1950,302,9,3,3,7,6,1,1,1,1,1,1
Italy,294,7,1950,1950,287,10,3,1,7,0,2,0,1,1,0,0
France,271,9,1950,1950,262,11,3,1,8,1,1,0,1,1,1,0
Wales,255,3,1950,1950,252,12,2,1,1,2,0,0,1,1,1,0
Finland,211,6,1950,1950,205,13,3,1,5,1,1,0,2,1,0,0
Northern Ireland,186,2,1950,1950,184,14,1,2,1,1,0,0,1,1,0,1
Poland,177,7,1950,1950,170,15,3,2,6,1,0,1,2,0,1,1
Paraguay,151,10,1950,1950,141,16,2,5,5,5,1,0,0,3,1,2
Spain,136,17,1950,1950,119,17,4,4,11,6,2,2,1,1,1,1
Romania,135,10,1950,1950,125,18,2,1,7,3,1,0,0,0,1,1
Curaçao,110,8,1950,1950,102,19,2,2,5,3,1,0,1,2,0,0
Trinidad and Tobago,99,22,1950,1950,77,20,4,5,14,8,3,4,0,1,1,0
Bulgaria,88,3,1950,1950,85,21,3,1,2,1,0,0,2,1,1,0
Chile,87,13,1950,1950,74,22,6,1,13,0,3,0,3,1,0,0
Ireland,67,3,1950,1950,64,23,1,1,2,1,0,0,0,1,1,0
Portugal,62,8,1950,1950,54,24,3,1,7,1,0,0,1,1,2,0
Turkey,42,10,1950,1950,32,25,2,1,9,1,2,0,0,1,0,0
Bolivia,41,2,1950,1950,39,26,2,1,2,0,1,0,1,1,0,0
Suriname,35,11,1950,1950,24,27,3,4,7,4,2,1,1,2,0,1
Mauritius,24,20,1950,1950,4,28,1,1,15,5,1,1,0,0,0,0
Mexico,24,1,1950,1950,23,29,1,1,1,0,0,0,1,1,0,0
Guyana,16,5,1950,1950,11,30,4,3,3,2,1,1,3,2,0,0
Israel,10,7,1950,1950,3,31,1,1,5,2,1,0,0,1,0,0
Albania,6,2,1950,1950,4,32,2,2,2,0,1,0,0,2,1,0
Iran,5,5,1950,1950,0,33,1,1,4,1,1,0,0,1,0,0
Zimbabwe,3,3,1950,1950,0,34,2,1,1,2,0,0,2,1,0,0
Sweden,773,14,1951,1950.1,759,1,4,4,9,5,2,0,1,3,1,1
Hungary,706,16,1951,1950.1,690,2,2,1,14,2,2,1,0,0,0,0
Austria,506,19,1951,1950.1,487,3,2,4,4,15,1,1,1,0,0,3
Scotland,500,15,1951,1950.1,485,4,3,4,4,11,2,3,1,1,0,0
Germany,481,14,1951,1950.1,467,5,2,4,5,9,1,3,1,1,0,0
England,422,16,1951,1950.1,406,6,6,1,15,1,3,0,1,0,2,1
Belgium,393,16,1951,1950.1,377,7,3,3,4,12,0,1,2,1,1,1
Denmark,372,8,1951,1950.1,364,8,3,2,7,1,2,0,0,2,1,0
Switzerland,335,9,1951,1950.1,326,9,3,2,4,5,0,0,2,2,1,0
Norway,330,15,1951,1950.1,315,10,3,3,7,8,2,2,1,0,0,1
Italy,304,10,1951,1950.1,294,11,2,2,5,5,1,1,0,0,1,1
France,280,9,1951,1950.1,271,12,1,5,2,7,0,1,0,2,1,2
Wales,264,9,1951,1950.1,255,13,3,2,6,3,2,2,0,0,1,0
Finland,218,7,1951,1950.1,211,14,1,5,1,6,0,0,0,4,1,1
Northern Ireland,189,3,1951,1950.1,186,15,3,1,3,0,0,0,2,1,1,0
Spain,145,9,1951,1950.1,136,16,1,2,6,3,1,0,0,0,0,2
Ireland,73,6,1951,1950.1,67,17,2,1,3,3,1,1,1,0,0,0
Portugal,67,5,1951,1950.1,62,18,2,2,2,3,0,0,1,2,1,0
Costa Rica,64,13,1951,1950.1,51,19,1,3,8,5,1,1,0,1,0,1
Turkey,46,4,1951,1950.1,42,20,2,2,1,3,1,1,1,1,0,0
Panama,45,14,1951,1950.1,31,21,4,1,13,1,3,0,0,1,1,0
Martinique,28,4,1951,1950.1,24,22,1,1,3,1,1,0,0,0,0,1
Luxembourg,25,4,1951,1950.1,21,23,1,1,3,1,1,0,0,1,0,0
New Zealand,24,24,1951,1950.1,0,24,1,5,9,15,1,3,0,2,0,0
Jamaica,22,7,1951,1950.1,15,25,3,3,4,3,1,1,1,2,1,0
Nicaragua,16,4,1951,1950.1,12,26,1,3,1,3,0,0,1,3,0,0
Madagascar,11,4,1951,1950.1,7,27,1,1,3,1,1,0,0,1,0,0
Kenya,6,4,1951,1950.1,2,28,1,1,2,2,1,0,0,1,0,0
Iceland,5,5,1951,1950.1,0,29,1,1,4,1,1,0,0,1,0,0
Guadeloupe,2,1,1951,1950.1,1,30,2,1,1,0,0,0,1,1,1,0
Sweden,795,22,1952,1950.2,773,1,3,6,8,14,2,4,0,1,1,1
Hungary,733,27,1952,1950.2,706,2,2,5,10,17,2,3,0,1,0,1
Austria,519,13,1952,1950.2,506,3,4,2,11,2,2,0,2,0,0,2
Scotland,513,13,1952,1950.2,500,4,3,3,8,5,1,2,1,1,1,0
Germany,496,15,1952,1950.2,481,5,2,6,8,7,2,1,0,4,0,1
England,443,21,1952,1950.2,422,6,2,5,10,11,2,3,0,0,0,2
Belgium,403,10,1952,1950.2,393,7,4,3,9,1,3,1,1,2,0,0
Netherlands,388,9,1952,1950.2,379,8,3,3,4,5,0,0,0,3,3,0
Denmark,381,9,1952,1950.2,372,9,4,2,5,4,1,0,3,2,0,0
Switzerland,344,9,1952,1950.2,335,10,3,3,3,6,0,1,2,2,1,0
Norway,342,12,1952,1950.2,330,11,3,1,9,3,1,1,2,0,0,0
Italy,308,4,1952,1950.2,304,12,2,2,3,1,1,0,0,1,1,1
France,294,14,1952,1950.2,280,13,5,3,9,5,3,2,2,0,0,1
Czech Republic,277,5,1952,1950.2,272,14,1,3,2,3,0,0,0,3,1,0
Wales,270,6,1952,1950.2,264,15,2,1,4,2,1,0,1,1,0,0
Finland,233,15,1952,1950.2,218,16,5,2,11,4,3,1,2,1,0,0
Northern Ireland,193,4,1952,1950.2,189,17,1,3,2,2,0,0,0,2,1,1
Poland,183,6,1952,1950.2,177,18,3,2,4,2,1,0,2,1,0,1
Spain,153,8,1952,1950.2,145,19,3,1,8,0,1,0,1,0,1,1
Brazil,149,14,1952,1950.2,135,20,4,1,11,3,3,1,0,0,1,0
Curaçao,119,9,1952,1950.2,110,21,2,1,6,3,2,0,0,0,0,1
Peru,75,14,1952,1950.2,61,22,1,4,2,12,0,2,1,1,0,1
Ireland,74,1,1952,1950.2,73,23,1,3,1,0,0,0,0,3,1,0
Portugal,69,2,1952,1950.2,67,24,2,1,2,0,0,0,1,1,1,0
Panama,50,5,1952,1950.2,45,25,2,3,2,3,0,0,2,3,0,0
Aruba,40,3,1952,1950.2,37,26,1,2,2,1,1,0,0,2,0,0
Martinique,29,1,1952,1950.2,28,27,1,1,1,0,0,0,1,1,0,0
Mexico,29,5,1952,1950.2,24,28,3,2,5,0,1,0,2,2,0,0
Madagascar,12,1,1952,1950.2,11,29,1,1,0,1,0,1,1,0,0,0
India,9,6,1952,1950.2,3,30,1,2,0,6,0,2,0,0,1,0
Guadeloupe,8,6,1952,1950.2,2,31,1,1,4,2,1,1,0,0,0,0
Sweden,816,21,1953,1950.3,795,1,5,6,9,12,2,2,2,1,1,3
Hungary,758,25,1953,1950.3,733,2,2,6,3,22,0,5,0,0,2,1
Austria,531,12,1953,1950.3,519,3,2,4,11,1,1,0,1,1,0,3
Scotland,522,9,1953,1950.3,513,4,2,2,4,5,0,1,1,0,1,1
Germany,502,6,1953,1950.3,496,5,3,1,5,1,1,0,0,0,2,1
England,465,22,1953,1950.3,443,6,3,6,8,14,1,3,1,2,1,1
Belgium,419,16,1953,1950.3,403,7,2,6,4,12,1,3,0,2,1,1
Denmark,399,18,1953,1950.3,381,8,3,3,11,7,2,3,1,0,0,0
Netherlands,391,3,1953,1950.3,388,9,4,1,3,0,1,0,3,1,0,0
Uruguay,357,17,1953,1950.3,340,10,1,6,2,15,1,3,0,2,0,1
Norway,355,13,1953,1950.3,342,11,4,3,8,5,2,1,1,1,1,1
Switzerland,354,10,1953,1950.3,344,12,3,3,4,6,0,2,2,1,1,0
France,322,28,1953,1950.3,294,13,4,3,17,11,3,2,1,1,0,0
Italy,313,5,1953,1950.3,308,14,2,2,3,2,1,1,1,1,0,0
Czech Republic,289,12,1953,1950.3,277,15,4,4,8,4,2,2,1,1,1,1
Wales,278,8,1953,1950.3,270,16,1,3,1,7,0,1,1,1,0,1
Finland,242,9,1953,1950.3,233,17,3,3,6,3,0,0,2,2,1,1
Northern Ireland,197,4,1953,1950.3,193,18,2,1,3,1,0,0,2,1,0,0
Poland,186,3,1953,1950.3,183,19,1,2,1,2,0,0,0,1,1,1
Brazil,166,17,1953,1950.3,149,20,5,2,9,8,3,1,2,1,0,0
Paraguay,165,14,1953,1950.3,151,21,1,6,2,12,0,4,0,0,1,2
Spain,160,7,1953,1950.3,153,22,2,2,5,2,1,1,0,1,1,0
Romania,140,5,1953,1950.3,135,23,2,1,3,2,1,1,1,0,0,0
Curaçao,136,17,1953,1950.3,119,24,2,4,11,6,1,1,1,1,0,2
Chile,101,14,1953,1950.3,87,25,5,5,8,6,2,1,3,2,0,2
Bulgaria,94,6,1953,1950.3,88,26,4,3,5,1,0,0,2,1,2,2
Ireland,85,11,1953,1950.3,74,27,3,1,11,0,2,0,1,1,0,0
Portugal,73,4,1953,1950.3,69,28,2,1,3,1,1,0,0,1,1,0
Guatemala,59,8,1953,1950.3,51,29,4,2,6,2,3,0,0,1,1,1
Panama,56,6,1953,1950.3,50,30,3,3,4,2,0,0,2,3,1,0
El Salvador,51,10,1953,1950.3,41,31,4,2,7,3,2,0,1,2,1,0
Bolivia,47,6,1953,1950.3,41,32,5,1,5,1,0,1,3,0,2,0
Mexico,41,12,1953,1950.3,29,33,1,1,8,4,1,1,0,0,0,0
Ecuador,36,1,1953,1950.3,35,34,2,4,0,1,0,0,1,3,1,1
Mauritius,36,12,1953,1950.3,24,35,1,1,9,3,1,1,0,0,0,0
Martinique,35,6,1953,1950.3,29,36,1,1,4,2,1,1,0,0,0,0
Honduras,30,13,1953,1950.3,17,37,2,4,5,8,2,2,0,2,0,0
Jamaica,26,4,1953,1950.3,22,38,2,2,3,1,1,0,1,2,0,0
Luxembourg,26,1,1953,1950.3,25,39,1,2,1,0,0,0,1,2,0,0
Uganda,24,11,1953,1950.3,13,40,1,1,9,2,1,0,0,1,0,0
South Korea,15,15,1953,1950.3,0,41,1,7,2,13,0,4,1,2,0,1
Guadeloupe,11,3,1953,1950.3,8,42,1,1,0,3,0,0,1,1,0,0
Haiti,11,5,1953,1950.3,6,43,3,1,5,0,2,0,1,1,0,0
Guinea-Bissau,4,4,1953,1950.3,0,44,1,1,1,3,1,1,0,0,0,0
Gambia,3,3,1953,1950.3,0,45,2,1,3,0,1,0,1,1,0,0
Sri Lanka,2,2,1953,1950.3,0,46,1,1,0,2,0,0,1,1,0,0
Sweden,852,36,1954,1950.4,816,1,6,3,25,11,6,1,0,1,0,1
Hungary,817,59,1954,1950.4,758,2,7,7,36,23,7,5,0,1,0,1
Austria,557,26,1954,1950.4,531,3,7,3,17,9,5,1,2,2,0,0
Germany,536,34,1954,1950.4,502,4,7,6,18,16,3,3,4,3,0,0
Scotland,533,11,1954,1950.4,522,5,5,4,7,4,1,2,3,1,1,1
England,486,21,1954,1950.4,465,6,3,5,8,13,2,3,1,1,0,1
Belgium,439,20,1954,1950.4,419,7,7,1,18,2,3,0,1,0,3,1
Denmark,405,6,1954,1950.4,399,8,3,2,2,4,0,0,2,1,1,1
Uruguay,378,21,1954,1950.4,357,9,1,7,1,20,0,3,1,2,0,2
Switzerland,375,21,1954,1950.4,354,10,7,2,20,1,3,0,3,1,1,1
Norway,364,9,1954,1950.4,355,11,3,7,5,4,1,2,0,5,2,0
France,334,12,1954,1950.4,322,12,3,2,6,6,1,1,1,0,1,1
Italy,329,16,1954,1950.4,313,13,2,4,7,9,2,2,0,2,0,0
Czech Republic,290,1,1954,1950.4,289,14,1,2,0,1,0,0,1,2,0,0
Wales,281,3,1954,1950.4,278,15,2,2,1,2,0,0,2,2,0,0
Finland,247,5,1954,1950.4,242,16,3,2,4,1,0,0,2,2,1,0
Northern Ireland,201,4,1954,1950.4,197,17,1,2,0,4,0,1,1,0,0,1
Poland,189,3,1954,1950.4,186,18,1,1,2,1,0,1,0,0,1,0
Brazil,177,11,1954,1950.4,166,19,3,2,8,3,2,2,1,0,0,0
Paraguay,177,12,1954,1950.4,165,20,3,2,5,7,1,2,1,0,1,0
Spain,166,6,1954,1950.4,160,21,1,2,4,2,1,0,0,1,0,1
Chile,106,5,1954,1950.4,101,22,4,2,5,0,1,0,3,2,0,0
Bulgaria,99,5,1954,1950.4,94,23,1,1,3,2,1,0,0,0,0,1
Ireland,88,3,1954,1950.4,85,24,1,1,2,1,1,1,0,0,0,0
Portugal,74,1,1954,1950.4,73,25,2,1,1,0,0,0,2,0,0,1
Turkey,60,14,1954,1950.4,46,26,2,4,3,11,1,1,0,3,1,0
Mexico,50,9,1954,1950.4,41,27,2,2,7,2,2,0,0,2,0,0
Martinique,41,6,1954,1950.4,35,28,1,1,2,4,0,1,0,0,1,0
Greece,32,3,1954,1950.4,29,29,1,1,1,2,0,1,0,0,1,0
Egypt,31,2,1954,1950.4,29,30,1,2,0,2,0,0,1,1,0,1
South Korea,22,7,1954,1950.4,15,31,1,3,0,7,0,1,1,1,0,1
Guadeloupe,15,4,1954,1950.4,11,32,1,1,2,2,0,0,1,0,0,1
Madagascar,15,3,1954,1950.4,12,33,1,1,2,1,0,0,1,1,0,0
Ethiopia,14,14,1954,1950.4,0,34,1,2,10,4,1,2,0,0,0,0
Israel,14,4,1954,1950.4,10,35,1,4,0,4,0,1,1,2,0,1
Iceland,8,3,1954,1950.4,5,36,1,1,1,2,1,0,0,1,0,0
Sri Lanka,6,4,1954,1950.4,2,37,1,2,1,3,0,1,1,0,0,1
Zambia,4,4,1954,1950.4,0,38,1,2,0,4,0,1,0,1,1,0
Djibouti,3,3,1954,1950.4,0,39,2,1,1,2,0,0,2,1,0,0
Myanmar,3,3,1954,1950.4,0,40,2,1,2,1,0,0,1,1,1,0
Ghana,2,2,1954,1950.4,0,41,1,1,2,0,1,0,0,1,0,0
Sweden,874,22,1955,1950.5,852,1,5,4,11,11,2,1,2,2,1,1
Hungary,870,53,1955,1950.5,817,2,5,7,16,37,4,6,0,0,1,1
Austria,568,11,1955,1950.5,557,3,2,4,3,8,0,2,1,2,1,0
Germany,548,12,1955,1950.5,536,4,4,3,6,6,3,1,1,2,0,0
Scotland,546,13,1955,1950.5,533,5,2,4,5,8,2,1,0,3,0,0
Argentina,522,18,1955,1950.5,504,6,4,1,17,1,3,1,0,0,1,0
England,508,22,1955,1950.5,486,7,3,5,14,8,3,1,0,3,0,1
Belgium,446,7,1955,1950.5,439,8,2,5,3,4,1,0,1,4,0,1
Denmark,417,12,1955,1950.5,405,9,4,3,6,6,1,1,2,0,1,2
Netherlands,402,11,1955,1950.5,391,10,5,1,11,0,3,0,0,1,2,0
Switzerland,383,8,1955,1950.5,375,11,4,1,7,1,0,0,4,1,0,0
Norway,370,6,1955,1950.5,364,12,4,4,2,4,0,1,3,2,1,1
France,344,10,1955,1950.5,334,13,2,4,3,7,2,2,0,1,0,1
Italy,334,5,1955,1950.5,329,14,2,2,3,2,2,1,0,1,0,0
Czech Republic,302,12,1955,1950.5,290,15,3,2,9,3,2,1,1,1,0,0
Wales,287,6,1955,1950.5,281,16,2,2,3,3,1,1,1,1,0,0
Finland,251,4,1955,1950.5,247,17,3,2,3,1,0,0,3,2,0,0
Northern Ireland,205,4,1955,1950.5,201,18,2,1,4,0,1,0,1,1,0,0
Paraguay,187,10,1955,1950.5,177,19,2,5,2,8,0,1,1,3,1,1
Spain,174,8,1955,1950.5,166,20,2,3,2,6,0,1,1,1,1,1
Romania,148,8,1955,1950.5,140,21,4,2,6,2,1,1,1,1,2,0
Curaçao,147,11,1955,1950.5,136,22,3,3,7,4,3,1,0,2,0,0
Chile,127,21,1955,1950.5,106,23,5,2,19,2,3,0,1,1,1,1
Bulgaria,109,10,1955,1950.5,99,24,3,4,6,4,2,1,0,2,1,1
Ireland,95,7,1955,1950.5,88,25,2,2,3,4,1,1,0,1,1,0
Costa Rica,93,29,1955,1950.5,64,26,5,3,24,5,5,2,0,1,0,0
Peru,88,13,1955,1950.5,75,27,1,4,2,11,1,1,0,1,0,2
Portugal,84,10,1955,1950.5,74,28,2,3,5,5,1,1,1,2,0,0
Guatemala,69,10,1955,1950.5,59,29,4,1,9,1,2,0,2,1,0,0
El Salvador,61,10,1955,1950.5,51,30,4,4,6,4,2,1,0,3,2,0
Aruba,48,8,1955,1950.5,40,31,1,4,4,4,1,0,0,3,0,1
Ecuador,40,4,1955,1950.5,36,32,3,2,3,1,0,0,3,2,0,0
Honduras,40,10,1955,1950.5,30,33,5,2,8,2,2,0,2,0,1,2
Egypt,33,2,1955,1950.5,31,34,2,1,1,1,1,0,1,1,0,0
Japan,26,1,1955,1950.5,25,35,1,1,0,1,0,1,0,0,1,0
Russia,24,23,1955,1950.5,1,36,3,2,16,7,2,1,0,0,1,1
Madagascar,21,6,1955,1950.5,15,37,1,1,2,4,1,1,0,0,0,0
Sri Lanka,10,4,1955,1950.5,6,38,1,1,3,1,0,0,1,1,0,0
Myanmar,9,6,1955,1950.5,3,39,3,2,4,2,1,0,2,1,0,1
Hungary,892,22,1956,1950.6,870,1,2,7,6,16,1,4,1,2,0,1
Sweden,883,9,1956,1950.6,874,2,3,3,3,6,0,2,0,1,3,0
Austria,580,12,1956,1950.6,568,3,3,3,9,3,1,0,2,2,0,1
Germany,566,18,1956,1950.6,548,4,5,5,10,8,2,2,3,2,0,1
Scotland,551,5,1956,1950.6,546,5,3,1,3,2,1,0,0,0,2,1
Argentina,545,23,1956,1950.6,522,6,12,5,18,5,7,3,1,1,4,1
England,527,19,1956,1950.6,508,7,3,4,12,7,3,1,0,0,0,3
Belgium,458,12,1956,1950.6,446,8,4,2,8,4,1,0,3,2,0,0
Denmark,432,15,1956,1950.6,417,9,3,5,6,9,0,1,2,3,1,1
Netherlands,414,12,1956,1950.6,402,10,1,5,1,11,0,4,1,0,0,1
Uruguay,395,17,1956,1950.6,378,11,8,3,13,4,5,0,2,1,1,2
Switzerland,394,11,1956,1950.6,383,12,4,2,5,6,0,2,2,0,2,0
Norway,381,11,1956,1950.6,370,13,4,3,5,6,1,1,1,2,2,0
France,356,12,1956,1950.6,344,14,4,1,12,0,3,0,1,1,0,0
Italy,342,8,1956,1950.6,334,15,3,3,7,1,3,0,0,2,0,1
Czech Republic,316,14,1956,1950.6,302,16,2,7,1,13,0,3,0,4,2,0
Wales,291,4,1956,1950.6,287,17,2,1,3,1,0,0,0,1,2,0
Finland,256,5,1956,1950.6,251,18,4,2,4,1,1,0,3,1,0,1
Brazil,218,41,1956,1950.6,177,19,10,14,21,20,7,7,2,2,1,5
Northern Ireland,207,2,1956,1950.6,205,20,1,2,1,1,0,0,0,1,1,1
Poland,202,13,1956,1950.6,189,21,4,3,11,2,2,0,2,1,0,2
Paraguay,194,7,1956,1950.6,187,22,5,4,5,2,0,0,3,3,2,1
Curaçao,156,9,1956,1950.6,147,23,2,2,6,3,2,2,0,0,0,0
Romania,150,2,1956,1950.6,148,24,2,1,2,0,1,0,1,1,0,0
Chile,145,18,1956,1950.6,127,25,5,5,12,6,3,1,1,4,1,0
Bulgaria,126,17,1956,1950.6,109,26,2,2,5,12,2,2,0,0,0,0
Costa Rica,104,11,1956,1950.6,93,27,1,4,4,7,1,1,0,2,0,1
Ireland,104,9,1956,1950.6,95,28,2,1,5,4,2,1,0,0,0,0
Lithuania,85,4,1956,1950.6,81,29,1,3,1,3,0,2,1,1,0,0
Turkey,66,6,1956,1950.6,60,30,3,2,4,2,1,0,1,1,1,1
Panama,61,5,1956,1950.6,56,31,2,2,2,3,0,0,2,2,0,0
Martinique,48,7,1956,1950.6,41,32,2,3,3,4,1,0,1,2,0,1
Russia,48,24,1956,1950.6,24,33,5,3,16,8,4,2,1,1,0,0
Mauritius,47,11,1956,1950.6,36,34,1,1,8,3,1,0,0,0,0,1
South Korea,38,16,1956,1950.6,22,35,3,4,6,10,3,3,0,0,0,1
Guadeloupe,18,3,1956,1950.6,15,36,2,1,3,0,0,0,1,1,1,0
Israel,18,4,1956,1950.6,14,37,1,1,1,3,0,1,1,0,0,0
India,16,7,1956,1950.6,9,38,1,1,0,7,0,1,1,0,0,0
Malaysia,11,11,1956,1950.6,0,39,1,1,9,2,1,0,0,1,0,0
Indonesia,10,10,1956,1950.6,0,40,1,2,7,3,1,0,0,2,0,0
Ghana,7,5,1956,1950.6,2,41,1,2,4,1,1,0,0,1,0,1
Cambodia,5,5,1956,1950.6,0,42,1,1,3,2,1,0,0,1,0,0
Belarus,4,4,1956,1950.6,0,43,1,2,1,3,1,0,0,2,0,0
Sierra Leone,4,4,1956,1950.6,0,44,1,1,1,3,1,0,0,1,0,0
Togo,2,2,1956,1950.6,0,45,1,1,1,1,0,0,0,0,1,1
Philippines,0,0,1956,1950.6,0,46,2,1,0,0,0,0,2,1,0,0
Hungary,907,15,1957,1950.7,892,1,4,4,12,3,3,1,1,2,0,1
Sweden,900,17,1957,1950.7,883,2,3,5,10,7,2,2,0,2,1,1
Austria,599,19,1957,1950.7,580,3,5,3,12,7,3,2,1,0,1,1
Argentina,587,42,1957,1950.7,545,4,8,7,33,9,7,3,0,3,1,1
Germany,582,16,1957,1950.7,566,5,6,4,9,7,4,2,2,2,0,0
Scotland,567,16,1957,1950.7,551,6,3,5,8,8,2,2,0,2,1,1
England,549,22,1957,1950.7,527,7,4,3,13,9,3,2,1,0,0,1
Belgium,476,18,1957,1950.7,458,8,4,4,9,9,2,1,1,1,1,2
Denmark,449,17,1957,1950.7,432,9,7,3,9,8,2,1,4,1,1,1
Netherlands,434,20,1957,1950.7,414,10,6,2,17,3,3,0,1,2,2,0
Uruguay,415,20,1957,1950.7,395,11,3,9,3,17,2,4,0,3,1,2
Switzerland,400,6,1957,1950.7,394,12,2,3,2,4,0,0,2,2,0,1
Norway,398,17,1957,1950.7,381,13,4,7,5,12,1,3,1,4,2,0
France,371,15,1957,1950.7,356,14,2,4,10,5,1,1,0,2,1,1
Italy,348,6,1957,1950.7,342,15,2,2,4,2,2,0,0,1,0,1
Czech Republic,329,13,1957,1950.7,316,16,2,4,5,8,2,2,0,1,0,1
Wales,298,7,1957,1950.7,291,17,3,4,5,2,2,0,1,2,0,2
Finland,262,6,1957,1950.7,256,18,5,4,4,2,1,0,4,4,0,0
Brazil,252,34,1957,1950.7,218,19,9,5,31,3,7,1,2,2,0,2
Northern Ireland,217,10,1957,1950.7,207,20,4,3,6,4,1,1,0,1,3,1
Paraguay,216,22,1957,1950.7,194,21,4,5,13,9,3,2,1,2,0,1
Poland,212,10,1957,1950.7,202,22,4,3,6,4,2,1,2,1,0,1
Spain,196,22,1957,1950.7,174,23,3,3,11,11,2,2,0,1,1,0
Curaçao,167,11,1957,1950.7,156,24,5,2,8,3,2,1,2,1,1,0
Chile,158,13,1957,1950.7,145,25,7,5,9,4,3,0,2,5,2,0
Romania,156,6,1957,1950.7,150,26,1,3,3,3,1,1,0,1,0,1
Bulgaria,141,15,1957,1950.7,126,27,4,4,9,6,1,1,2,1,1,2
Costa Rica,120,16,1957,1950.7,104,28,3,3,8,8,2,2,0,1,1,0
Ireland,108,4,1957,1950.7,104,29,1,2,1,3,0,1,0,1,1,0
Peru,102,14,1957,1950.7,88,30,8,1,14,0,4,0,3,1,1,0
Portugal,89,5,1957,1950.7,84,31,2,4,4,1,1,0,0,4,1,0
Guatemala,73,4,1957,1950.7,69,32,2,1,3,1,0,0,2,1,0,0
Russia,73,25,1957,1950.7,48,33,3,5,6,19,2,4,0,1,1,0
Mexico,71,21,1957,1950.7,50,34,4,2,13,8,4,1,0,0,0,1
Turkey,68,2,1957,1950.7,66,35,1,1,1,1,0,1,0,0,1,0
Bolivia,61,14,1957,1950.7,47,36,4,4,10,4,3,1,0,3,1,0
Martinique,56,8,1957,1950.7,48,37,1,1,6,2,1,0,0,1,0,0
Ecuador,47,7,1957,1950.7,40,38,1,5,2,5,0,0,1,4,0,1
Egypt,44,11,1957,1950.7,33,39,2,2,5,6,1,2,1,0,0,0
China,43,12,1957,1950.7,31,40,4,2,11,1,3,0,0,2,1,0
Greece,33,1,1957,1950.7,32,41,1,1,1,0,0,0,1,1,0,0
Luxembourg,29,3,1957,1950.7,26,42,1,3,0,3,0,0,1,3,0,0
Colombia,27,14,1957,1950.7,13,43,5,6,9,5,2,0,2,6,1,0
Guadeloupe,24,6,1957,1950.7,18,44,1,1,5,1,1,0,0,1,0,0
Malaysia,24,13,1957,1950.7,11,45,3,1,10,3,1,1,1,0,1,0
Myanmar,22,13,1957,1950.7,9,46,4,1,11,2,3,0,1,1,0,0
USA,22,5,1957,1950.7,17,47,2,2,4,1,0,0,2,2,0,0
Madagascar,21,0,1957,1950.7,21,48,1,1,0,0,0,0,1,1,0,0
Indonesia,20,10,1957,1950.7,10,49,2,3,6,4,2,0,0,2,0,1
Iceland,16,8,1957,1950.7,8,50,4,2,5,3,0,0,4,2,0,0
Ghana,13,6,1957,1950.7,7,51,1,1,3,3,0,1,0,0,1,0
Singapore,12,12,1957,1950.7,0,52,2,2,8,4,1,1,1,0,0,1
Hong Kong,11,11,1957,1950.7,0,53,1,2,2,9,1,1,0,0,0,1
Canada,10,8,1957,1950.7,2,54,1,3,5,3,1,1,0,2,0,0
Cambodia,9,4,1957,1950.7,5,55,4,1,4,0,0,0,3,1,1,0
Cuba,7,1,1957,1950.7,6,56,3,1,1,0,0,0,3,1,0,0
Sudan,7,7,1957,1950.7,0,57,3,2,5,2,1,0,2,1,0,1
Syria,1,1,1957,1950.7,0,58,1,1,1,0,0,0,0,1,1,0
Sweden,928,28,1958,1950.8,900,1,8,2,19,9,5,2,1,0,2,0
Hungary,924,17,1958,1950.8,907,2,4,5,9,8,2,2,1,2,1,1
Germany,623,41,1958,1950.8,582,3,8,11,18,23,4,2,0,5,4,4
Austria,610,11,1958,1950.8,599,4,6,1,9,2,2,0,3,0,1,1
Argentina,596,9,1958,1950.8,587,5,5,2,9,0,3,0,2,2,0,0
Scotland,578,11,1958,1950.8,567,6,3,4,3,8,0,2,1,2,2,0
England,570,21,1958,1950.8,549,7,5,5,11,10,2,1,1,0,2,4
Belgium,484,8,1958,1950.8,476,8,4,2,5,3,0,1,3,1,1,0
Netherlands,469,35,1958,1950.8,434,9,5,3,25,10,4,2,1,0,0,1
Denmark,466,17,1958,1950.8,449,10,4,4,8,9,2,1,1,2,1,1
Uruguay,416,1,1958,1950.8,415,11,1,1,1,0,1,0,0,1,0,0
Norway,409,11,1958,1950.8,398,12,4,2,8,3,2,1,1,1,1,0
France,408,37,1958,1950.8,371,13,9,3,32,5,5,1,0,1,4,1
Switzerland,403,3,1958,1950.8,400,14,1,4,0,3,0,0,1,3,0,1
Italy,354,6,1958,1950.8,348,15,1,3,1,5,0,0,0,2,1,1
Czech Republic,345,16,1958,1950.8,329,16,7,3,9,7,2,1,4,1,1,1
Wales,309,11,1958,1950.8,298,17,3,7,3,8,1,2,1,1,1,4
Brazil,280,28,1958,1950.8,252,18,8,2,20,8,6,2,0,0,2,0
Finland,264,2,1958,1950.8,262,19,2,1,2,0,0,0,2,1,0,0
Northern Ireland,233,16,1958,1950.8,217,20,2,8,5,11,1,2,0,3,1,3
Paraguay,224,8,1958,1950.8,216,21,2,4,4,4,2,0,0,3,0,1
Poland,221,9,1958,1950.8,212,22,3,3,4,5,0,0,2,1,1,2
Spain,205,9,1958,1950.8,196,23,2,2,7,2,2,0,0,1,0,1
Romania,162,6,1958,1950.8,156,24,2,1,4,2,1,0,1,1,0,0
Ireland,113,5,1958,1950.8,108,25,1,2,2,3,0,0,0,1,1,1
Russia,84,11,1958,1950.8,73,26,2,7,4,7,1,3,0,3,1,1
Mexico,72,1,1958,1950.8,71,27,1,2,1,0,0,0,0,2,1,0
Turkey,72,4,1958,1950.8,68,28,2,3,1,3,1,1,0,1,1,1
Malaysia,52,28,1958,1950.8,24,29,5,3,20,8,4,1,1,0,0,2
Indonesia,37,17,1958,1950.8,20,30,1,5,2,15,1,4,0,1,0,0
New Zealand,37,13,1958,1950.8,24,31,2,3,4,9,0,3,1,0,1,0
Greece,35,2,1958,1950.8,33,32,1,1,1,1,0,0,0,1,1,0
Madagascar,27,6,1958,1950.8,21,33,1,1,3,3,1,1,0,0,0,0
Uganda,26,2,1958,1950.8,24,34,1,1,2,0,1,0,0,1,0,0
Singapore,22,10,1958,1950.8,12,35,4,4,7,3,0,0,2,4,2,0
Ghana,20,7,1958,1950.8,13,36,1,1,5,2,1,0,0,1,0,0
Israel,18,0,1958,1950.8,18,37,1,1,0,0,0,0,1,1,0,0
Sweden,952,24,1959,1950.9,928,1,3,4,11,13,3,2,0,2,0,0
Hungary,941,17,1959,1950.9,924,2,4,2,15,2,3,1,1,0,0,1
Germany,648,25,1959,1950.9,623,3,5,6,10,15,2,1,2,4,1,1
Austria,627,17,1959,1950.9,610,4,2,4,9,8,2,2,0,2,0,0
Argentina,626,30,1959,1950.9,596,5,9,2,27,3,7,0,1,1,1,1
England,588,18,1959,1950.9,570,6,4,5,7,11,2,1,1,3,1,1
Scotland,587,9,1959,1950.9,578,7,1,4,3,6,1,2,0,2,0,0
Belgium,491,7,1959,1950.9,484,8,1,4,0,7,0,0,1,2,0,2
Netherlands,490,21,1959,1950.9,469,9,4,3,19,2,2,0,1,2,1,1
Denmark,477,11,1959,1950.9,466,10,3,3,6,5,1,1,1,2,1,0
Uruguay,445,29,1959,1950.9,416,11,1,10,1,28,0,5,1,4,0,1
France,424,16,1959,1950.9,408,12,4,1,16,0,3,0,0,1,1,0
Norway,419,10,1959,1950.9,409,13,2,4,1,9,1,1,1,3,0,0
Switzerland,407,4,1959,1950.9,403,14,2,1,4,0,1,0,1,1,0,0
Czech Republic,360,15,1959,1950.9,345,15,3,4,11,4,3,0,0,3,0,1
Italy,359,5,1959,1950.9,354,16,2,2,2,3,0,0,0,1,2,1
Brazil,316,36,1959,1950.9,280,17,9,5,25,11,7,3,1,1,1,1
Wales,311,2,1959,1950.9,309,18,1,1,1,1,0,0,0,1,1,0
Finland,270,6,1959,1950.9,264,19,2,2,5,1,1,0,1,2,0,0
Paraguay,245,21,1959,1950.9,224,20,3,8,4,17,1,3,1,5,1,0
Northern Ireland,238,5,1959,1950.9,233,21,2,1,4,1,1,0,1,1,0,0
Poland,234,13,1959,1950.9,221,22,3,3,11,2,1,0,2,1,0,2
Spain,222,17,1959,1950.9,205,23,2,3,9,8,2,1,0,1,0,1
Chile,171,13,1959,1950.9,158,24,4,5,7,6,2,1,1,4,1,0
Costa Rica,128,8,1959,1950.9,120,25,2,1,7,1,1,0,1,1,0,0
Ireland,118,5,1959,1950.9,113,26,2,1,5,0,2,0,0,1,0,0
Peru,116,14,1959,1950.9,102,27,2,5,9,5,2,0,0,2,0,3
Portugal,101,12,1959,1950.9,89,28,2,4,4,8,2,1,0,3,0,0
Russia,89,5,1959,1950.9,84,29,1,2,3,2,1,2,0,0,0,0
Mexico,79,7,1959,1950.9,72,30,2,1,5,2,2,1,0,0,0,0
Martinique,67,11,1959,1950.9,56,31,4,2,10,1,3,0,1,2,0,0
Bolivia,65,4,1959,1950.9,61,32,5,1,4,0,0,0,4,1,1,0
Malaysia,60,8,1959,1950.9,52,33,2,1,3,5,0,1,2,0,0,0
South Korea,57,19,1959,1950.9,38,34,1,6,4,15,1,4,0,0,0,2
Suriname,45,10,1959,1950.9,35,35,2,4,5,5,2,0,0,3,0,1
Japan,43,17,1959,1950.9,26,36,3,5,5,12,1,2,1,2,1,1
Singapore,34,12,1959,1950.9,22,37,5,3,10,2,1,0,4,3,0,0
Guadeloupe,32,8,1959,1950.9,24,38,2,2,6,2,1,1,0,1,1,0
Israel,29,11,1959,1950.9,18,39,3,4,4,7,1,1,0,2,2,1
Hong Kong,26,15,1959,1950.9,11,40,5,1,8,7,1,1,3,0,1,0
India,26,10,1959,1950.9,16,41,4,2,5,5,2,2,1,0,1,0
Barbados,20,3,1959,1950.9,17,42,2,1,3,0,1,0,1,1,0,0
Guyana,20,4,1959,1950.9,16,43,1,2,2,2,0,0,0,2,1,0
Ethiopia,14,0,1959,1950.9,14,44,1,1,0,0,0,0,1,1,0,0
Nigeria,13,13,1959,1950.9,0,45,1,2,10,3,1,1,0,1,0,0
Iran,9,4,1959,1950.9,5,46,1,1,3,1,1,0,0,0,0,1
Kenya,9,3,1959,1950.9,6,47,2,1,1,2,1,1,0,0,1,0
Pakistan,2,2,1959,1950.9,0,48,1,2,2,0,0,0,0,2,1,0
Benin,1,1,1959,1950.9,0,49,1,1,0,1,0,0,1,1,0,0
Sweden,965,13,1960,1960,952,1,4,2,9,4,4,1,0,1,0,0
Hungary,953,12,1960,1960,941,2,4,1,11,1,3,0,0,1,1,0
Germany,676,28,1960,1960,648,3,5,7,9,19,3,5,2,2,0,0
Argentina,659,33,1960,1960,626,4,10,4,24,9,8,2,2,1,0,1
Austria,643,16,1960,1960,627,5,4,4,12,4,3,2,1,2,0,0
England,612,24,1960,1960,588,6,2,5,9,15,2,2,0,2,0,1
Scotland,601,14,1960,1960,587,7,3,4,8,6,1,0,1,3,1,1
Netherlands,505,15,1960,1960,490,8,1,7,4,11,1,2,0,4,0,1
Belgium,504,13,1960,1960,491,9,7,2,12,1,4,0,2,2,1,0
Denmark,492,15,1960,1960,477,10,4,1,15,0,3,0,1,1,0,0
Uruguay,453,8,1960,1960,445,11,3,2,5,3,2,1,0,1,1,0
France,443,19,1960,1960,424,12,3,6,9,10,2,2,1,3,0,1
Norway,434,15,1960,1960,419,13,4,2,14,1,3,0,1,2,0,0
Switzerland,425,18,1960,1960,407,14,3,3,13,5,3,1,0,2,0,0
Czech Republic,375,15,1960,1960,360,15,4,2,11,4,3,2,1,0,0,0
Italy,364,5,1960,1960,359,16,2,1,4,1,1,0,1,1,0,0
Brazil,358,42,1960,1960,316,17,4,12,13,29,3,8,0,4,1,0
Wales,320,9,1960,1960,311,18,2,2,5,4,2,1,0,1,0,0
Finland,276,6,1960,1960,270,19,2,3,1,5,0,0,2,3,0,0
Paraguay,249,4,1960,1960,245,20,1,4,1,3,0,0,1,4,0,0
Northern Ireland,247,9,1960,1960,238,21,2,2,5,4,0,0,2,2,0,0
Poland,245,11,1960,1960,234,22,2,3,6,5,1,1,0,2,1,0
Spain,241,19,1960,1960,222,23,2,6,6,13,2,3,0,3,0,0
Chile,187,16,1960,1960,171,24,5,7,10,6,2,0,3,5,0,2
Curaçao,178,11,1960,1960,167,25,3,5,1,10,1,2,0,1,2,2
Romania,162,0,1960,1960,162,26,1,1,0,0,0,0,1,1,0,0
Bulgaria,153,12,1960,1960,141,27,4,3,10,2,4,0,0,3,0,0
Costa Rica,149,21,1960,1960,128,28,8,2,16,5,4,0,2,1,2,1
Ireland,127,9,1960,1960,118,29,3,2,7,2,2,1,1,1,0,0
Russia,101,12,1960,1960,89,30,1,3,7,5,1,2,0,1,0,0
Mexico,93,14,1960,1960,79,31,2,5,6,8,2,0,0,3,0,2
Guatemala,80,7,1960,1960,73,32,1,2,4,3,0,0,0,1,1,1
Turkey,77,5,1960,1960,72,33,1,1,4,1,1,0,0,1,0,0
Martinique,73,6,1960,1960,67,34,2,4,3,3,1,0,0,1,1,3
South Korea,71,14,1960,1960,57,35,6,1,14,0,5,0,0,0,1,1
Malaysia,60,0,1960,1960,60,36,2,1,0,0,0,0,0,1,2,0
Indonesia,51,14,1960,1960,37,37,3,1,14,0,3,0,0,1,0,0
Ecuador,50,3,1960,1960,47,38,1,1,3,0,0,0,1,1,0,0
Suriname,49,4,1960,1960,45,39,2,2,4,0,0,0,2,1,0,1
Egypt,47,3,1960,1960,44,40,3,1,1,2,0,0,3,0,0,1
Ghana,46,26,1960,1960,20,41,4,4,17,9,3,2,0,0,1,2
Honduras,46,6,1960,1960,40,42,3,1,6,0,1,0,0,1,2,0
Singapore,46,12,1960,1960,34,43,2,2,7,5,2,0,0,1,0,1
Greece,37,2,1960,1960,35,44,1,1,0,2,0,0,1,1,0,0
Israel,37,8,1960,1960,29,45,2,2,7,1,2,0,0,1,0,1
Hong Kong,30,4,1960,1960,26,46,1,1,3,1,1,0,0,1,0,0
Nigeria,30,17,1960,1960,13,47,6,4,13,4,2,0,2,2,2,2
India,28,2,1960,1960,26,48,1,2,2,0,0,0,0,1,1,1
USA,25,3,1960,1960,22,49,1,1,3,0,0,0,0,1,1,0
Cameroon,17,17,1960,1960,0,50,3,1,12,5,2,1,0,0,1,0
Iceland,16,0,1960,1960,16,51,1,1,0,0,0,0,1,1,0,0
Kenya,15,6,1960,1960,9,52,1,1,5,1,1,0,0,0,0,1
Mali,14,14,1960,1960,0,53,2,4,4,10,2,2,0,2,0,0
Pakistan,12,10,1960,1960,2,54,1,3,7,3,1,0,0,3,0,0
Guinea-Bissau,11,7,1960,1960,4,55,2,1,6,1,1,0,1,1,0,0
Tunisia,9,9,1960,1960,0,56,3,4,4,5,2,0,1,3,0,1
Ivory Coast,5,5,1960,1960,0,57,1,1,3,2,1,0,0,1,0,0
Morocco,5,5,1960,1960,0,58,2,1,4,1,1,0,1,1,0,0
Iraq,4,4,1960,1960,0,59,1,1,3,1,1,0,0,1,0,0
Cyprus,2,2,1960,1960,0,60,1,1,1,1,0,0,0,1,1,0
Sweden,983,18,1961,1960.1,965,1,3,5,10,8,3,2,0,3,0,0
Hungary,973,20,1961,1960.1,953,2,4,7,9,11,2,3,1,2,1,2
Germany,695,19,1961,1960.1,676,3,7,6,14,5,4,1,2,4,1,1
Argentina,671,12,1961,1960.1,659,4,2,6,6,6,1,1,1,2,0,3
Austria,651,8,1961,1960.1,643,5,2,2,5,3,2,2,0,0,0,0
England,642,30,1961,1960.1,612,6,5,4,24,6,4,1,0,1,1,2
Scotland,624,23,1961,1960.1,601,7,3,5,9,14,3,2,0,3,0,0
Belgium,519,15,1961,1960.1,504,8,3,5,7,8,2,1,1,3,0,1
Netherlands,516,11,1961,1960.1,505,9,4,2,7,4,1,0,3,0,0,2
Denmark,508,16,1961,1960.1,492,10,3,3,11,5,1,1,1,2,1,0
Uruguay,461,8,1961,1960.1,453,11,3,2,4,4,1,1,1,0,1,1
France,450,7,1961,1960.1,443,12,3,4,7,0,1,0,0,4,2,0
Norway,440,6,1961,1960.1,434,13,4,5,1,5,0,0,3,4,1,1
Switzerland,432,7,1961,1960.1,425,14,3,1,7,0,3,0,0,1,0,0
Czech Republic,402,27,1961,1960.1,375,15,6,2,22,5,5,1,0,1,1,0
Italy,383,19,1961,1960.1,364,16,4,1,15,4,3,1,1,0,0,0
Brazil,369,11,1961,1960.1,358,17,1,4,3,8,1,4,0,0,0,0
Wales,330,10,1961,1960.1,320,18,2,4,2,8,0,1,1,2,1,1
Finland,283,7,1961,1960.1,276,19,2,4,4,3,1,0,1,4,0,0
Northern Ireland,256,9,1961,1960.1,247,20,3,4,4,5,1,0,2,3,0,1
Paraguay,254,5,1961,1960.1,249,21,4,4,2,3,0,0,2,3,2,1
Spain,253,12,1961,1960.1,241,22,4,3,8,4,3,2,0,0,1,1
Curaçao,184,6,1961,1960.1,178,23,5,2,6,0,2,0,1,2,2,0
Romania,167,5,1961,1960.1,162,24,1,1,4,1,1,1,0,0,0,0
Costa Rica,162,13,1961,1960.1,149,25,4,2,12,1,4,0,0,2,0,0
Bulgaria,160,7,1961,1960.1,153,26,3,2,5,2,3,1,0,1,0,0
Ireland,130,3,1961,1960.1,127,27,2,2,1,2,0,0,2,2,0,0
Peru,119,3,1961,1960.1,116,28,1,2,1,2,0,0,0,2,1,0
Russia,117,16,1961,1960.1,101,29,4,6,6,10,2,5,1,1,1,0
Portugal,110,9,1961,1960.1,101,30,3,2,7,2,1,0,1,2,1,0
Mexico,109,16,1961,1960.1,93,31,3,7,12,4,3,1,0,3,0,3
Guatemala,83,3,1961,1960.1,80,32,1,1,1,2,0,1,1,0,0,0
Turkey,82,5,1961,1960.1,77,33,4,3,4,1,2,1,2,2,0,0
Bolivia,67,2,1961,1960.1,65,34,1,1,1,1,0,0,0,1,1,0
Malaysia,66,6,1961,1960.1,60,35,1,2,1,5,0,1,1,1,0,0
Panama,65,4,1961,1960.1,61,36,5,2,2,2,0,1,4,1,1,0
Indonesia,61,10,1961,1960.1,51,37,4,2,6,4,3,1,1,0,0,1
Ghana,59,13,1961,1960.1,46,38,5,2,13,0,3,0,0,1,2,1
Singapore,55,9,1961,1960.1,46,39,1,2,5,4,1,1,0,1,0,0
Japan,49,6,1961,1960.1,43,40,2,2,3,3,1,1,1,1,0,0
Israel,44,7,1961,1960.1,37,41,4,1,7,0,2,0,1,1,1,0
Greece,40,3,1961,1960.1,37,42,1,2,2,1,1,0,0,2,0,0
Nigeria,39,9,1961,1960.1,30,43,2,5,2,7,1,1,0,3,1,1
Luxembourg,34,5,1961,1960.1,29,44,1,2,4,1,1,0,0,2,0,0
Uganda,32,6,1961,1960.1,26,45,2,4,2,4,1,1,1,3,0,0
Colombia,31,4,1961,1960.1,27,46,2,1,3,1,2,0,0,0,0,1
Kenya,28,13,1961,1960.1,15,47,4,4,6,7,2,2,1,2,1,0
Haiti,24,13,1961,1960.1,11,48,2,4,3,10,1,4,1,0,0,0
Ethiopia,20,6,1961,1960.1,14,49,1,2,4,2,1,0,0,2,0,0
Morocco,13,8,1961,1960.1,5,50,4,3,4,4,2,1,1,1,1,1
Tunisia,13,4,1961,1960.1,9,51,1,2,2,2,1,0,0,1,0,1
Cuba,9,2,1961,1960.1,7,52,3,1,1,1,0,0,3,1,0,0
Tanzania,4,4,1961,1960.1,0,53,2,1,4,0,1,0,1,0,0,1
Dominica,2,2,1961,1960.1,0,54,1,1,1,1,0,0,1,1,0,0
Sweden,1003,20,1962,1960.2,983,1,4,6,8,12,2,5,1,1,1,0
Hungary,996,23,1962,1960.2,973,2,4,7,8,15,3,5,0,1,1,1
Germany,724,29,1962,1960.2,695,3,8,4,21,8,6,3,0,1,2,0
Argentina,680,9,1962,1960.2,671,4,6,2,7,2,4,0,1,0,1,2
England,665,23,1962,1960.2,642,5,5,6,12,11,3,3,1,2,1,1
Austria,661,10,1962,1960.2,651,6,4,6,4,6,1,1,3,3,0,2
Scotland,636,12,1962,1960.2,624,7,3,1,9,3,2,1,1,0,0,0
Denmark,540,32,1962,1960.2,508,8,4,5,19,13,4,2,0,2,0,1
Netherlands,534,18,1962,1960.2,516,9,3,4,15,3,3,0,0,4,0,0
Belgium,528,9,1962,1960.2,519,10,4,2,7,2,2,1,1,1,1,0
Uruguay,471,10,1962,1960.2,461,11,1,8,1,9,0,2,0,5,1,1
France,457,7,1962,1960.2,450,12,2,3,3,4,0,0,2,1,0,2
Norway,456,16,1962,1960.2,440,13,5,3,11,5,4,1,1,1,0,1
Czech Republic,419,17,1962,1960.2,402,14,5,5,8,9,4,1,1,3,0,1
Brazil,402,33,1962,1960.2,369,15,11,1,29,4,10,1,0,0,1,0
Italy,399,16,1962,1960.2,383,16,3,4,11,5,3,2,0,1,0,1
Wales,340,10,1962,1960.2,330,17,2,5,6,4,1,0,1,5,0,0
Finland,285,2,1962,1960.2,283,18,2,1,1,1,0,0,2,1,0,0
Spain,263,10,1962,1960.2,253,19,1,5,6,4,1,1,0,3,0,1
Northern Ireland,262,6,1962,1960.2,256,20,2,4,3,3,1,1,1,3,0,0
Poland,256,11,1962,1960.2,245,21,4,5,3,8,1,2,2,3,1,0
Chile,197,10,1962,1960.2,187,22,6,1,10,0,3,0,2,1,1,0
Curaçao,193,9,1962,1960.2,184,23,1,5,1,8,1,1,0,3,0,1
Romania,177,10,1962,1960.2,167,24,2,3,7,3,2,0,0,3,0,0
Bulgaria,168,8,1962,1960.2,160,25,5,3,7,1,2,0,1,3,2,0
Ireland,137,7,1962,1960.2,130,26,2,1,6,1,1,0,1,0,0,1
Russia,136,19,1962,1960.2,117,27,3,4,9,10,3,2,0,1,0,1
Mexico,118,9,1962,1960.2,109,28,3,5,3,6,2,2,1,2,0,1
Portugal,116,6,1962,1960.2,110,29,2,3,4,2,1,0,1,3,0,0
Ghana,92,33,1962,1960.2,59,30,2,6,6,27,1,5,0,0,1,1
Turkey,90,8,1962,1960.2,82,31,3,4,5,3,2,1,0,2,1,1
Indonesia,85,24,1962,1960.2,61,32,6,3,22,2,5,1,1,2,0,0
Malaysia,76,10,1962,1960.2,66,33,5,1,9,1,2,0,1,1,2,0
Singapore,67,12,1962,1960.2,55,34,4,2,7,5,1,1,2,1,1,0
Suriname,58,9,1962,1960.2,49,35,2,5,6,3,1,0,0,2,1,3
Japan,54,5,1962,1960.2,49,36,1,3,1,4,0,0,0,2,1,1
Egypt,52,5,1962,1960.2,47,37,2,1,3,2,2,0,0,1,0,0
Israel,45,1,1962,1960.2,44,38,2,1,1,0,0,0,1,1,1,0
Guadeloupe,43,11,1962,1960.2,32,39,2,3,4,7,2,1,0,1,0,1
Kenya,41,13,1962,1960.2,28,40,3,3,8,5,2,0,1,3,0,0
Uganda,39,7,1962,1960.2,32,41,2,4,4,3,1,0,1,4,0,0
Colombia,38,7,1962,1960.2,31,42,4,1,7,0,0,0,2,1,2,0
Ethiopia,36,16,1962,1960.2,20,43,4,2,14,2,3,0,0,2,1,0
Myanmar,27,5,1962,1960.2,22,44,2,1,3,2,1,0,1,1,0,0
Cameroon,23,6,1962,1960.2,17,45,1,3,0,6,0,1,1,1,0,1
Tunisia,23,10,1962,1960.2,13,46,2,2,5,5,1,0,0,2,1,0
Iceland,20,4,1962,1960.2,16,47,2,1,2,2,0,0,1,1,1,0
Mali,19,5,1962,1960.2,14,48,4,1,5,0,1,0,3,0,0,1
Morocco,18,5,1962,1960.2,13,49,2,2,4,1,1,0,1,1,0,1
Tanzania,18,14,1962,1960.2,4,50,3,1,11,3,2,0,1,1,0,0
Congo,13,13,1962,1960.2,0,51,2,2,9,4,2,1,0,1,0,0
Libya,8,8,1962,1960.2,0,52,1,1,6,2,1,0,0,0,0,1
Thailand,7,7,1962,1960.2,0,53,2,2,5,2,1,0,1,2,0,0
Gabon,5,5,1962,1960.2,0,54,2,1,4,1,1,0,0,1,1,0
Guinea,3,3,1962,1960.2,0,55,1,1,2,1,0,0,1,1,0,0
Malawi,2,2,1962,1960.2,0,56,1,1,0,2,0,0,1,1,0,0
Malta,2,2,1962,1960.2,0,57,1,2,1,1,0,0,1,2,0,0
Philippines,0,0,1962,1960.2,0,58,1,1,0,0,0,0,1,1,0,0
Hungary,1014,18,1963,1960.3,996,1,3,5,11,7,2,1,0,1,1,3
Sweden,1010,7,1963,1960.3,1003,2,4,2,4,3,2,1,0,0,2,1
Germany,747,23,1963,1960.3,724,3,5,6,7,16,1,2,3,2,1,2
Argentina,706,26,1963,1960.3,680,4,6,4,15,11,3,2,2,2,1,0
England,695,30,1963,1960.3,665,5,3,5,10,20,1,4,1,1,1,0
Austria,668,7,1963,1960.3,661,6,3,4,3,4,1,0,1,4,1,0
Scotland,660,24,1963,1960.3,636,7,3,5,12,12,3,2,0,3,0,0
Denmark,557,17,1963,1960.3,540,8,5,4,10,7,2,1,0,2,3,1
Netherlands,540,6,1963,1960.3,534,9,6,1,5,1,2,0,2,0,2,1
Belgium,539,11,1963,1960.3,528,10,1,4,5,6,1,3,0,0,0,1
Uruguay,474,3,1963,1960.3,471,11,1,1,3,0,1,0,0,0,0,1
France,470,13,1963,1960.3,457,12,5,3,13,0,2,0,2,2,1,1
Norway,465,9,1963,1960.3,456,13,3,5,6,3,1,1,2,3,0,1
Brazil,436,34,1963,1960.3,402,14,6,12,15,19,3,4,2,6,1,2
Switzerland,436,4,1963,1960.3,432,15,3,2,2,2,0,0,2,1,1,1
Czech Republic,425,6,1963,1960.3,419,16,3,2,5,1,0,0,1,2,2,0
Italy,406,7,1963,1960.3,399,17,3,3,5,2,2,2,0,1,1,0
Wales,346,6,1963,1960.3,340,18,2,2,1,5,0,1,1,1,1,0
Finland,288,3,1963,1960.3,285,19,1,2,2,1,1,0,0,0,0,2
Paraguay,280,26,1963,1960.3,254,20,5,6,14,12,3,4,1,1,1,1
Poland,276,20,1963,1960.3,256,21,4,2,14,6,2,1,0,1,2,0
Northern Ireland,269,7,1963,1960.3,262,22,3,2,3,4,1,0,2,1,0,1
Spain,268,5,1963,1960.3,263,23,4,1,4,1,0,1,2,0,2,0
Chile,199,2,1963,1960.3,197,24,1,1,0,2,0,0,0,1,1,0
Romania,181,4,1963,1960.3,177,25,1,2,3,1,1,0,0,0,0,2
Bulgaria,175,7,1963,1960.3,168,26,4,3,4,3,3,0,0,2,1,1
Costa Rica,175,13,1963,1960.3,162,27,4,2,8,5,3,1,0,1,1,0
Ireland,141,4,1963,1960.3,137,28,2,1,4,0,2,0,0,0,0,1
Russia,141,5,1963,1960.3,136,29,3,2,3,2,1,0,1,0,1,2
Mexico,127,9,1963,1960.3,118,30,1,2,1,8,0,1,1,0,0,1
Portugal,117,1,1963,1960.3,116,31,1,1,1,0,1,0,0,1,0,0
Egypt,94,42,1963,1960.3,52,32,7,3,35,7,5,1,1,0,1,2
Malaysia,92,16,1963,1960.3,76,33,5,1,13,3,2,0,2,1,1,0
Turkey,90,0,1963,1960.3,90,34,2,2,0,0,0,0,1,1,1,1
Bolivia,87,20,1963,1960.3,67,35,6,2,19,1,5,0,0,2,1,0
Martinique,79,6,1963,1960.3,73,36,1,1,6,0,1,0,0,1,0,0
South Korea,77,6,1963,1960.3,71,37,2,1,6,0,1,0,0,1,1,0
China,68,25,1963,1960.3,43,38,2,10,7,18,2,4,0,3,0,3
El Salvador,66,5,1963,1960.3,61,39,1,3,3,2,1,1,0,0,0,2
Ecuador,64,14,1963,1960.3,50,40,2,4,2,12,0,1,2,1,0,2
Nigeria,60,21,1963,1960.3,39,41,5,5,13,8,3,1,1,2,1,2
Ethiopia,57,21,1963,1960.3,36,42,2,6,8,13,2,4,0,2,0,0
Kenya,55,14,1963,1960.3,41,43,6,2,13,1,2,1,3,1,1,0
Colombia,53,15,1963,1960.3,38,44,5,3,11,4,1,0,3,3,1,0
Honduras,52,6,1963,1960.3,46,45,1,3,1,5,0,2,1,1,0,0
Uganda,49,10,1963,1960.3,39,46,1,4,1,9,0,2,1,0,0,2
Greece,44,4,1963,1960.3,40,47,1,2,3,1,1,0,0,2,0,0
Tunisia,43,20,1963,1960.3,23,48,3,8,4,16,2,4,0,3,1,1
Luxembourg,42,8,1963,1960.3,34,49,1,4,3,5,0,1,0,1,1,2
Jamaica,33,7,1963,1960.3,26,50,9,1,7,0,1,0,6,1,2,0
Myanmar,30,3,1963,1960.3,27,51,3,1,3,0,1,0,2,1,0,0
Haiti,29,5,1963,1960.3,24,52,1,2,0,5,0,1,0,1,1,0
Mali,26,7,1963,1960.3,19,53,2,3,4,3,2,0,0,3,0,0
Tanzania,22,4,1963,1960.3,18,54,3,2,1,3,0,0,2,2,1,0
Sudan,20,13,1963,1960.3,7,55,1,6,5,8,1,2,0,2,0,2
Nicaragua,17,1,1963,1960.3,16,56,1,1,0,1,0,0,1,1,0,0
Thailand,15,8,1963,1960.3,7,57,1,4,1,7,0,0,1,2,0,2
Guinea,12,9,1963,1960.3,3,58,1,3,1,8,1,1,0,0,0,2
Lebanon,11,11,1963,1960.3,0,59,3,1,11,0,2,0,1,1,0,0
Albania,7,1,1963,1960.3,6,60,1,1,1,0,1,0,0,1,0,0
Syria,5,4,1963,1960.3,1,61,1,1,0,4,0,1,1,0,0,0
Algeria,4,4,1963,1960.3,0,62,2,1,4,0,1,0,0,0,1,1
Kuwait,4,4,1963,1960.3,0,63,3,2,3,1,1,0,2,2,0,0
Benin,3,2,1963,1960.3,1,64,1,1,1,1,0,0,0,1,1,0
Senegal,3,3,1963,1960.3,0,65,2,2,2,1,0,0,1,2,1,0
Liberia,2,2,1963,1960.3,0,66,1,1,2,0,0,0,0,1,1,0
Jordan,1,1,1963,1960.3,0,67,1,2,0,1,0,0,1,2,0,0
Hungary,1027,13,1964,1960.4,1014,1,3,4,7,6,2,2,0,2,1,0
Sweden,1022,12,1964,1960.4,1010,2,3,5,8,4,1,1,0,2,2,2
Germany,769,22,1964,1960.4,747,3,3,4,6,16,0,2,1,2,2,0
Argentina,726,20,1964,1960.4,706,4,4,3,16,4,4,1,0,1,0,1
England,725,30,1964,1960.4,695,5,4,8,7,23,2,4,0,3,2,1
Austria,671,3,1964,1960.4,668,6,3,1,2,1,2,0,1,0,0,1
Scotland,671,11,1964,1960.4,660,7,3,2,7,4,3,0,0,1,0,1
Denmark,567,10,1964,1960.4,557,8,3,6,3,7,2,1,1,5,0,0
Belgium,546,7,1964,1960.4,539,9,4,2,5,2,2,0,1,1,1,1
Netherlands,546,6,1964,1960.4,540,10,4,3,4,2,1,1,1,1,2,1
France,475,5,1964,1960.4,470,11,2,3,2,3,1,1,1,2,0,0
Norway,474,9,1964,1960.4,465,12,4,3,7,2,2,1,1,2,1,0
Switzerland,445,9,1964,1960.4,436,13,5,2,7,2,2,0,3,2,0,0
Italy,418,12,1964,1960.4,406,14,3,1,9,3,2,1,0,0,1,0
Wales,352,6,1964,1960.4,346,15,2,3,5,1,1,0,1,3,0,0
Finland,296,8,1964,1960.4,288,16,3,4,4,4,2,1,1,3,0,0
Poland,289,13,1964,1960.4,276,17,2,3,5,8,2,1,0,1,0,1
Paraguay,284,4,1964,1960.4,280,18,1,1,3,1,1,0,0,1,0,0
Northern Ireland,282,13,1964,1960.4,269,19,3,3,7,6,2,1,1,2,0,0
Spain,280,12,1964,1960.4,268,20,3,2,9,3,3,1,0,1,0,0
Chile,200,1,1964,1960.4,199,21,1,1,1,0,0,0,0,1,1,0
Bulgaria,175,0,1964,1960.4,175,22,1,1,0,0,0,0,0,0,1,1
Russia,152,11,1964,1960.4,141,23,2,6,4,7,2,1,0,2,0,3
Ireland,151,10,1964,1960.4,141,24,3,3,4,6,1,1,2,2,0,0
Portugal,129,12,1964,1960.4,117,25,2,5,5,7,1,2,1,2,0,1
Ghana,108,16,1964,1960.4,92,26,3,1,12,4,3,1,0,0,0,0
Kenya,67,12,1964,1960.4,55,27,3,4,6,6,1,1,2,3,0,0
Uganda,62,13,1964,1960.4,49,28,2,4,10,3,2,2,0,2,0,0
Israel,53,8,1964,1960.4,45,29,4,1,5,3,3,1,1,0,0,0
Guadeloupe,47,4,1964,1960.4,43,30,1,1,4,0,1,0,0,1,0,0
Tunisia,47,4,1964,1960.4,43,31,1,1,3,1,1,0,0,1,0,0
Cameroon,46,23,1964,1960.4,23,32,7,1,19,4,4,0,1,0,2,1
India,45,17,1964,1960.4,28,33,3,4,10,7,3,2,0,2,0,0
Myanmar,36,6,1964,1960.4,30,34,2,1,3,3,1,1,1,0,0,0
Hong Kong,33,3,1964,1960.4,30,35,3,3,1,2,0,0,3,2,0,1
Congo,32,19,1964,1960.4,13,36,5,2,17,2,2,0,1,2,2,0
Zambia,27,23,1964,1960.4,4,37,4,3,8,15,1,2,3,1,0,0
Tanzania,26,4,1964,1960.4,22,38,2,1,4,0,2,0,0,1,0,0
Libya,18,10,1964,1960.4,8,39,3,2,4,6,1,1,1,0,1,1
Algeria,8,4,1964,1960.4,4,40,2,1,4,0,1,0,0,1,1,0
Albania,7,0,1964,1960.4,7,41,1,1,0,0,0,0,1,1,0,0
Iraq,6,2,1964,1960.4,4,42,1,1,1,1,1,1,0,0,0,0
Jordan,3,2,1964,1960.4,1,43,2,1,2,0,0,0,1,1,1,0
Hungary,1040,13,1965,1960.5,1027,1,3,4,8,5,3,1,0,2,0,1
Sweden,1038,16,1965,1960.5,1022,2,7,2,10,6,1,1,3,1,3,0
Germany,797,28,1965,1960.5,769,3,6,8,12,16,3,4,1,3,2,1
Argentina,738,12,1965,1960.5,726,4,4,5,9,3,3,1,0,0,1,4
England,737,12,1965,1960.5,725,5,4,4,7,5,2,3,1,0,1,1
Scotland,684,13,1965,1960.5,671,6,4,5,6,7,2,1,1,2,1,2
Austria,678,7,1965,1960.5,671,7,2,6,1,6,0,2,1,3,1,1
Denmark,581,14,1965,1960.5,567,8,4,4,7,7,2,1,1,2,1,1
Belgium,560,14,1965,1960.5,546,9,4,4,7,7,2,2,1,2,1,0
Netherlands,549,3,1965,1960.5,546,10,2,3,0,3,0,1,0,2,2,0
Uruguay,492,18,1965,1960.5,474,11,6,5,13,5,3,2,2,2,1,1
Norway,487,13,1965,1960.5,474,12,4,2,13,0,2,0,1,1,1,1
France,481,6,1965,1960.5,475,13,3,1,5,1,1,1,1,0,1,0
Brazil,461,25,1965,1960.5,436,14,6,4,17,8,4,3,0,0,2,1
Switzerland,450,5,1965,1960.5,445,15,3,3,3,2,2,1,1,0,0,2
Czech Republic,437,12,1965,1960.5,425,16,3,3,6,6,2,1,1,1,0,1
Italy,437,19,1965,1960.5,418,17,3,6,13,6,3,1,0,2,0,3
Wales,370,18,1965,1960.5,352,18,4,4,10,8,3,1,0,3,1,0
Finland,306,10,1965,1960.5,296,19,4,3,7,3,2,0,2,2,0,1
Poland,301,12,1965,1960.5,289,20,4,4,9,3,1,1,0,2,3,1
Paraguay,297,13,1965,1960.5,284,21,3,8,4,9,2,3,0,4,1,1
Northern Ireland,293,11,1965,1960.5,282,22,4,3,9,2,3,0,1,1,0,2
Spain,285,5,1965,1960.5,280,23,2,3,4,1,1,1,1,1,0,1
Chile,221,21,1965,1960.5,200,24,6,5,17,4,4,1,0,2,2,2
Costa Rica,205,30,1965,1960.5,175,25,10,6,22,8,6,3,1,1,3,2
Curaçao,200,7,1965,1960.5,193,26,2,8,1,6,0,1,1,4,1,3
Bulgaria,194,19,1965,1960.5,175,27,4,4,14,5,4,2,0,1,0,1
Romania,190,9,1965,1960.5,181,28,3,3,6,3,3,0,0,3,0,0
Russia,177,25,1965,1960.5,152,29,5,6,11,14,3,3,1,1,1,2
Mexico,160,33,1965,1960.5,127,30,5,8,19,14,5,5,0,0,0,3
Ghana,155,47,1965,1960.5,108,31,4,7,16,31,4,5,0,1,0,1
Ireland,153,2,1965,1960.5,151,32,3,1,1,1,1,0,2,1,0,0
Portugal,138,9,1965,1960.5,129,33,4,3,7,2,2,2,0,1,2,0
Peru,128,9,1965,1960.5,119,34,4,3,1,8,1,1,3,2,0,0
Trinidad and Tobago,104,5,1965,1960.5,99,35,2,4,4,1,1,0,1,4,0,0
Turkey,101,11,1965,1960.5,90,36,3,8,2,9,1,2,2,5,0,1
Kenya,95,28,1965,1960.5,67,37,7,6,16,12,3,1,2,3,2,2
Bolivia,91,4,1965,1960.5,87,38,2,2,3,1,1,0,1,2,0,0
Indonesia,91,6,1965,1960.5,85,39,1,3,5,1,1,0,0,2,0,1
South Korea,84,7,1965,1960.5,77,40,2,3,3,4,0,3,1,0,1,0
China,76,8,1965,1960.5,68,41,2,1,5,3,2,1,0,0,0,0
El Salvador,76,10,1965,1960.5,66,42,4,1,8,2,2,1,1,0,1,0
Uganda,73,11,1965,1960.5,62,43,6,2,10,1,1,0,2,2,3,0
Ecuador,71,7,1965,1960.5,64,44,2,3,4,3,1,1,0,2,1,0
Singapore,71,4,1965,1960.5,67,45,2,2,2,2,0,1,2,0,0,1
Nigeria,66,6,1965,1960.5,60,46,2,3,0,6,0,1,2,1,0,1
Suriname,66,8,1965,1960.5,58,47,2,2,7,1,1,0,1,2,0,0
Ethiopia,65,8,1965,1960.5,57,48,3,3,4,4,2,1,1,2,0,0
Colombia,57,4,1965,1960.5,53,49,2,2,2,2,1,0,1,2,0,0
Honduras,55,3,1965,1960.5,52,50,5,2,2,1,0,0,3,2,2,0
Israel,54,1,1965,1960.5,53,51,4,2,1,0,0,0,3,2,1,0
Tunisia,54,7,1965,1960.5,47,52,4,1,6,1,1,1,1,0,2,0
India,53,8,1965,1960.5,45,53,1,4,0,8,0,2,1,0,0,2
Greece,48,4,1965,1960.5,44,54,1,3,1,3,0,0,1,2,0,1
Jamaica,48,15,1965,1960.5,33,55,5,5,11,4,3,1,1,3,1,1
Hong Kong,42,9,1965,1960.5,33,56,8,1,7,2,1,0,4,1,3,0
Congo,37,5,1965,1960.5,32,57,5,2,4,1,1,0,4,1,0,1
Zambia,37,10,1965,1960.5,27,58,3,1,8,2,1,0,1,0,1,1
Mali,34,8,1965,1960.5,26,59,3,3,3,5,1,1,1,2,1,0
USA,29,4,1965,1960.5,25,60,1,3,2,2,0,1,0,1,1,1
Sudan,28,8,1965,1960.5,20,61,1,3,4,4,1,1,0,1,0,1
Guinea,21,9,1965,1960.5,12,62,3,2,8,1,3,0,0,2,0,0
Ivory Coast,21,16,1965,1960.5,5,63,4,5,8,8,3,3,1,2,0,0
Morocco,20,2,1965,1960.5,18,64,1,4,0,2,0,1,1,1,0,2
Democratic Republic of the Congo,17,17,1965,1960.5,0,65,4,5,9,8,2,2,2,3,0,0
Pakistan,14,2,1965,1960.5,12,66,1,1,1,1,0,0,1,1,0,0
Senegal,14,11,1965,1960.5,3,67,1,5,3,8,1,2,0,2,0,1
Cuba,12,3,1965,1960.5,9,68,3,1,3,0,1,0,1,1,1,0
Albania,9,2,1965,1960.5,7,69,2,2,1,1,0,0,1,2,1,0
Australia,7,7,1965,1960.5,0,70,1,4,3,4,1,2,0,1,0,1
Liberia,6,4,1965,1960.5,2,71,2,2,2,2,1,0,1,2,0,0
Kuwait,5,1,1965,1960.5,4,72,1,1,0,1,0,0,1,1,0,0
Cyprus,4,2,1965,1960.5,2,73,3,2,2,0,1,0,2,2,0,0
Venezuela,4,4,1965,1960.5,0,74,2,2,4,0,0,0,2,2,0,0
Hungary,1067,27,1966,1960.6,1040,1,6,4,18,9,4,2,2,0,0,2
Sweden,1054,16,1966,1960.6,1038,2,3,5,8,8,2,2,1,2,0,1
Germany,849,52,1966,1960.6,797,3,11,8,36,16,11,4,0,2,0,2
England,773,36,1966,1960.6,737,4,10,6,18,18,7,6,0,0,3,0
Argentina,743,5,1966,1960.6,738,5,4,2,5,0,2,0,0,2,2,0
Scotland,691,7,1966,1960.6,684,6,5,1,6,1,1,0,3,0,1,1
Austria,683,5,1966,1960.6,678,7,3,4,3,2,2,0,1,3,0,1
Denmark,587,6,1966,1960.6,581,8,5,4,4,2,1,0,3,4,1,0
Belgium,569,9,1966,1960.6,560,9,4,2,5,4,2,1,2,1,0,0
Netherlands,563,14,1966,1960.6,549,10,5,2,10,4,2,1,2,1,1,0
Uruguay,502,10,1966,1960.6,492,11,1,9,3,7,1,2,0,3,0,4
Brazil,494,33,1966,1960.6,461,12,13,4,27,6,9,2,2,1,2,1
France,494,13,1966,1960.6,481,13,5,5,4,9,1,1,2,3,2,1
Norway,494,7,1966,1960.6,487,14,3,4,4,3,0,1,2,3,1,0
Italy,458,21,1966,1960.6,437,15,7,2,19,2,6,1,1,0,0,1
Switzerland,457,7,1966,1960.6,450,16,2,6,3,4,0,0,0,6,2,0
Czech Republic,443,6,1966,1960.6,437,17,1,4,1,5,0,1,1,1,0,2
Wales,374,4,1966,1960.6,370,18,2,4,2,2,0,0,1,4,1,0
Poland,315,14,1966,1960.6,301,19,4,8,6,8,1,0,1,5,2,3
Finland,312,6,1966,1960.6,306,20,5,3,3,3,2,0,2,2,1,1
Paraguay,305,8,1966,1960.6,297,21,2,3,5,3,1,0,0,2,1,1
Northern Ireland,302,9,1966,1960.6,293,22,3,2,4,5,1,1,2,1,0,0
Spain,292,7,1966,1960.6,285,23,3,3,5,2,2,0,0,2,1,1
Chile,234,13,1966,1960.6,221,24,8,5,10,3,3,0,5,3,0,2
Romania,207,17,1966,1960.6,190,25,3,6,9,8,3,2,0,4,0,0
Curaçao,205,5,1966,1960.6,200,26,2,3,1,4,0,1,0,2,2,0
Bulgaria,202,8,1966,1960.6,194,27,3,3,5,3,1,0,2,2,0,1
Russia,198,21,1966,1960.6,177,28,3,12,5,16,0,8,1,3,2,1
Mexico,172,12,1966,1960.6,160,29,3,6,8,4,2,1,0,3,1,2
Ghana,171,16,1966,1960.6,155,30,1,4,6,10,1,2,0,0,0,2
Portugal,163,25,1966,1960.6,138,31,5,6,11,14,4,5,1,1,0,0
Ireland,158,5,1966,1960.6,153,32,3,3,2,3,1,1,1,2,1,0
Kenya,115,20,1966,1960.6,95,33,4,6,6,14,1,4,1,2,2,0
China,113,37,1966,1960.6,76,34,5,1,33,4,5,1,0,0,0,0
Trinidad and Tobago,113,9,1966,1960.6,104,35,4,1,9,0,3,0,1,1,0,0
Turkey,104,3,1966,1960.6,101,36,1,4,0,3,0,1,1,1,0,2
Egypt,98,4,1966,1960.6,94,37,1,2,2,2,0,0,0,1,1,1
South Korea,92,8,1966,1960.6,84,38,1,5,2,6,1,3,0,2,0,0
Uganda,83,10,1966,1960.6,73,39,2,5,3,7,0,1,2,2,0,2
Singapore,75,4,1966,1960.6,71,40,1,2,1,3,0,1,1,0,0,1
Ecuador,74,3,1966,1960.6,71,41,1,1,2,1,0,0,0,1,1,0
Nigeria,74,8,1966,1960.6,66,42,2,3,4,4,1,1,0,1,1,1
Israel,67,13,1966,1960.6,54,43,4,2,9,4,1,1,2,1,1,0
Zambia,65,28,1966,1960.6,37,44,4,4,11,17,3,4,1,0,0,0
Colombia,59,2,1966,1960.6,57,45,1,1,0,2,0,0,0,1,1,0
India,56,3,1966,1960.6,53,46,2,1,1,2,1,1,1,0,0,0
Cameroon,52,6,1966,1960.6,46,47,2,1,4,2,1,0,1,0,0,1
Jamaica,52,4,1966,1960.6,48,48,2,3,3,1,0,0,1,2,1,1
Guadeloupe,49,2,1966,1960.6,47,49,2,3,0,2,0,1,2,1,0,1
Libya,45,27,1966,1960.6,18,50,8,3,26,1,3,0,2,3,3,0
Myanmar,45,9,1966,1960.6,36,51,4,1,9,0,3,0,0,0,1,1
Hong Kong,44,2,1966,1960.6,42,52,3,1,2,0,0,0,2,1,1,0
Luxembourg,42,0,1966,1960.6,42,53,1,1,0,0,0,0,1,1,0,0
Mali,35,1,1966,1960.6,34,54,1,2,1,0,1,0,0,2,0,0
Democratic Republic of the Congo,34,17,1966,1960.6,17,55,4,3,10,7,3,1,1,2,0,0
Sudan,34,6,1966,1960.6,28,56,1,3,2,4,1,1,0,1,0,1
Guinea,33,12,1966,1960.6,21,57,3,1,12,0,2,0,0,1,1,0
Madagascar,33,6,1966,1960.6,27,58,1,1,0,6,0,1,1,0,0,0
Tanzania,32,6,1966,1960.6,26,59,2,1,2,4,0,0,2,1,0,0
Iraq,29,23,1966,1960.6,6,60,8,1,21,2,5,1,2,0,1,0
Morocco,26,6,1966,1960.6,20,61,1,4,1,5,1,2,0,1,0,1
Ivory Coast,24,3,1966,1960.6,21,62,1,1,1,2,0,1,0,0,1,0
Lebanon,22,11,1966,1960.6,11,63,1,5,0,11,0,3,1,1,0,1
Syria,14,9,1966,1960.6,5,64,1,5,4,5,1,2,0,2,0,1
Kuwait,13,8,1966,1960.6,5,65,1,3,1,7,0,0,1,1,0,2
Palestine,13,13,1966,1960.6,0,66,3,2,13,0,2,0,1,1,0,1
Togo,12,10,1966,1960.6,2,67,4,4,5,5,1,0,1,2,2,2
Algeria,10,2,1966,1960.6,8,68,1,1,2,0,0,0,0,1,1,0
Dominica,10,8,1966,1960.6,2,69,1,1,5,3,1,0,0,0,0,1
Jordan,9,6,1966,1960.6,3,70,2,2,3,3,0,1,1,1,1,0
Liberia,9,3,1966,1960.6,6,71,1,1,2,1,1,0,0,0,0,1
Benin,8,5,1966,1960.6,3,72,3,1,5,0,0,0,2,1,1,0
Bahrain,7,7,1966,1960.6,0,73,3,1,6,1,0,0,2,1,1,0
Malawi,5,3,1966,1960.6,2,74,4,1,2,1,0,0,4,1,0,0
Sierra Leone,5,1,1966,1960.6,4,75,1,1,1,0,0,0,0,1,1,0
Malta,4,2,1966,1960.6,2,76,1,1,1,1,1,1,0,0,0,0
Papua New Guinea,2,2,1966,1960.6,0,77,1,1,2,0,0,0,1,1,0,0
Central African Republic,1,1,1966,1960.6,0,78,1,1,1,0,0,0,1,1,0,0
Hungary,1086,19,1967,1960.7,1067,1,2,7,5,14,2,5,0,2,0,0
Sweden,1064,10,1967,1960.7,1054,2,5,3,8,2,2,0,2,2,1,1
Germany,887,38,1967,1960.7,849,3,7,11,25,13,7,4,0,3,0,4
England,785,12,1967,1960.7,773,4,4,2,8,4,2,2,1,0,1,0
Argentina,758,15,1967,1960.7,743,5,3,6,11,4,3,1,0,4,0,1
Scotland,699,8,1967,1960.7,691,6,2,3,3,5,1,2,1,1,0,0
Austria,692,9,1967,1960.7,683,7,5,2,5,4,2,0,2,2,1,0
Denmark,616,29,1967,1960.7,587,8,6,2,22,7,3,1,1,1,2,0
Belgium,582,13,1967,1960.7,569,9,3,3,6,7,2,1,1,1,0,1
Netherlands,573,10,1967,1960.7,563,10,2,4,4,6,2,0,0,4,0,0
Uruguay,522,20,1967,1960.7,502,11,9,2,17,3,4,2,0,0,5,0
France,506,12,1967,1960.7,494,12,4,2,7,5,1,1,2,1,1,0
Norway,503,9,1967,1960.7,494,13,4,3,4,5,1,1,2,2,1,0
Switzerland,476,19,1967,1960.7,457,14,4,4,15,4,2,1,1,2,1,1
Italy,473,15,1967,1960.7,458,15,3,3,10,5,2,2,0,0,1,1
Czech Republic,453,10,1967,1960.7,443,16,3,4,5,5,2,2,1,1,0,1
Wales,376,2,1967,1960.7,374,17,1,2,0,2,0,0,1,1,0,1
Poland,323,8,1967,1960.7,315,18,3,2,4,4,1,1,1,0,1,1
Finland,316,4,1967,1960.7,312,19,3,4,3,1,0,0,2,4,1,0
Paraguay,315,10,1967,1960.7,305,20,2,4,2,8,1,1,0,3,1,0
Northern Ireland,303,1,1967,1960.7,302,21,2,1,1,0,1,0,0,1,1,0
Spain,296,4,1967,1960.7,292,22,2,3,4,0,2,0,0,2,0,1
Chile,251,17,1967,1960.7,234,23,7,3,15,2,4,0,3,1,0,2
Russia,233,35,1967,1960.7,198,24,6,9,14,21,4,6,1,2,1,1
Romania,222,15,1967,1960.7,207,25,3,6,8,7,2,2,1,1,0,3
Bulgaria,209,7,1967,1960.7,202,26,3,4,5,2,2,1,1,1,0,2
Curaçao,209,4,1967,1960.7,205,27,3,1,3,1,0,0,2,0,1,1
Ghana,193,22,1967,1960.7,171,28,6,5,14,8,4,1,0,2,2,2
Mexico,191,19,1967,1960.7,172,29,7,6,15,4,5,3,2,3,0,0
Portugal,169,6,1967,1960.7,163,30,2,4,2,4,1,1,0,1,1,2
Ireland,161,3,1967,1960.7,158,31,1,2,0,3,0,1,1,1,0,0
Kenya,135,20,1967,1960.7,115,32,7,2,20,0,4,0,2,2,1,0
Trinidad and Tobago,131,18,1967,1960.7,113,33,4,6,7,11,3,4,0,1,1,1
South Korea,121,29,1967,1960.7,92,34,6,7,18,11,5,4,0,2,1,1
Turkey,114,10,1967,1960.7,104,35,3,5,2,8,1,2,0,2,2,1
Indonesia,110,19,1967,1960.7,91,36,4,5,13,6,3,1,1,3,0,1
Malaysia,101,9,1967,1960.7,92,37,4,3,6,3,1,1,2,2,1,0
Guatemala,98,15,1967,1960.7,83,38,5,2,11,4,5,1,0,0,0,1
Martinique,92,13,1967,1960.7,79,39,1,4,2,11,1,2,0,1,0,1
Bolivia,91,0,1967,1960.7,91,40,3,2,0,0,0,0,2,2,1,0
Uganda,89,6,1967,1960.7,83,41,3,2,3,3,0,1,3,1,0,0
Singapore,85,10,1967,1960.7,75,42,2,5,7,3,1,0,0,5,1,0
El Salvador,82,6,1967,1960.7,76,43,3,1,6,0,2,0,1,1,0,0
Nigeria,81,7,1967,1960.7,74,44,3,5,4,3,0,0,0,3,3,2
Ethiopia,80,15,1967,1960.7,65,45,3,5,6,9,3,2,0,2,0,1
Democratic Republic of the Congo,73,39,1967,1960.7,34,46,8,11,14,25,5,5,1,5,2,1
India,63,7,1967,1960.7,56,47,4,3,3,4,0,1,1,1,3,1
Greece,59,11,1967,1960.7,48,48,4,3,9,2,2,0,2,1,0,2
Tunisia,59,5,1967,1960.7,54,49,3,1,5,0,1,0,0,1,2,0
Congo,57,20,1967,1960.7,37,50,3,7,12,8,3,1,0,2,0,4
Honduras,57,2,1967,1960.7,55,51,2,1,1,1,0,0,1,1,1,0
Jamaica,56,4,1967,1960.7,52,52,4,2,4,0,1,0,1,2,2,0
Guadeloupe,54,5,1967,1960.7,49,53,1,2,0,5,0,1,1,1,0,0
Cameroon,53,1,1967,1960.7,52,54,1,1,1,0,0,0,0,1,1,0
Mauritius,53,6,1967,1960.7,47,55,2,3,1,5,0,2,1,1,1,0
New Zealand,51,14,1967,1960.7,37,56,1,3,3,11,1,1,0,2,0,0
Hong Kong,50,6,1967,1960.7,44,57,7,1,6,0,2,0,5,1,0,0
Sudan,50,16,1967,1960.7,34,58,5,5,9,7,3,0,1,3,1,2
Libya,47,2,1967,1960.7,45,59,3,1,2,0,0,0,2,1,1,0
Mali,44,9,1967,1960.7,35,60,3,2,6,3,2,1,0,0,1,1
Tanzania,44,12,1967,1960.7,32,61,5,7,6,6,2,0,2,5,1,2
Luxembourg,43,1,1967,1960.7,42,62,2,2,0,1,0,0,1,2,1,0
Ivory Coast,39,15,1967,1960.7,24,63,3,5,6,9,2,2,0,1,1,2
Iraq,37,8,1967,1960.7,29,64,2,2,3,5,0,2,0,0,2,0
Haiti,34,5,1967,1960.7,29,65,2,4,2,3,0,2,2,1,0,1
Nicaragua,22,5,1967,1960.7,17,66,2,2,4,1,1,0,1,2,0,0
Pakistan,19,5,1967,1960.7,14,67,1,2,4,1,0,0,1,1,0,1
Cuba,17,5,1967,1960.7,12,68,2,2,2,3,0,0,1,1,1,1
Algeria,15,5,1967,1960.7,10,69,2,1,3,2,1,1,1,0,0,0
Togo,14,2,1967,1960.7,12,70,2,1,2,0,0,0,2,1,0,0
Burkina Faso,13,13,1967,1960.7,0,71,4,4,7,6,2,1,2,3,0,0
Liberia,11,2,1967,1960.7,9,72,1,1,1,1,0,0,1,0,0,1
Venezuela,11,7,1967,1960.7,4,73,1,4,3,4,0,1,1,3,0,0
Albania,9,0,1967,1960.7,9,74,1,1,0,0,0,0,0,1,1,0
Grenada,6,6,1967,1960.7,0,75,1,1,2,4,1,1,0,0,0,0
Niger,5,5,1967,1960.7,0,76,2,1,3,2,0,0,2,1,0,0
Cyprus,4,0,1967,1960.7,4,77,1,3,0,0,0,0,1,3,0,0
Hungary,1088,2,1968,1960.8,1086,1,1,1,2,0,1,0,0,1,0,0
Sweden,1083,19,1968,1960.8,1064,2,4,5,10,9,2,2,0,2,2,1
Germany,902,15,1968,1960.8,887,3,2,10,3,12,2,3,0,1,0,6
England,795,10,1968,1960.8,785,4,4,4,7,3,3,1,0,1,1,2
Argentina,773,15,1968,1960.8,758,5,3,7,7,8,3,0,0,5,0,2
Scotland,708,9,1968,1960.8,699,6,2,3,3,6,1,2,0,0,1,1
Austria,704,12,1968,1960.8,692,7,3,4,8,4,1,0,1,3,1,1
Denmark,631,15,1968,1960.8,616,8,4,4,10,5,2,1,2,2,0,1
Belgium,596,14,1968,1960.8,582,9,2,5,7,7,1,3,1,1,0,1
Netherlands,576,3,1968,1960.8,573,10,3,3,3,0,1,0,1,1,1,2
Brazil,538,44,1968,1960.8,494,11,7,10,18,26,5,6,1,4,1,0
Uruguay,529,7,1968,1960.8,522,12,2,6,2,5,1,0,1,3,0,3
Norway,515,12,1968,1960.8,503,13,3,4,6,6,1,2,1,2,1,0
Switzerland,480,4,1968,1960.8,476,14,3,3,2,2,2,0,0,3,1,0
Italy,478,5,1968,1960.8,473,15,2,2,2,3,1,1,0,1,1,0
Czech Republic,460,7,1968,1960.8,453,16,2,1,4,3,2,1,0,0,0,0
Poland,344,21,1968,1960.8,323,17,5,3,13,8,2,1,1,1,2,1
Finland,320,4,1968,1960.8,316,18,3,2,2,2,0,0,3,2,0,0
Northern Ireland,313,10,1968,1960.8,303,19,1,3,4,6,1,2,0,1,0,0
Spain,305,9,1968,1960.8,296,20,3,3,5,4,1,1,1,1,1,1
Chile,260,9,1968,1960.8,251,21,3,3,7,2,3,1,0,1,0,1
Russia,243,10,1968,1960.8,233,22,3,7,7,3,3,0,0,2,0,5
Romania,225,3,1968,1960.8,222,23,3,2,2,1,1,0,0,1,2,1
Bulgaria,217,8,1968,1960.8,209,24,2,3,5,3,2,1,0,1,0,1
Costa Rica,217,12,1968,1960.8,205,25,4,3,10,2,3,0,0,1,1,2
Mexico,216,25,1968,1960.8,191,26,10,6,15,10,3,3,1,2,6,1
Curaçao,213,4,1968,1960.8,209,27,2,3,3,1,1,0,0,3,1,0
Ghana,211,18,1968,1960.8,193,28,5,3,13,5,4,2,0,1,1,0
Portugal,174,5,1968,1960.8,169,29,2,1,3,2,1,0,1,1,0,0
Ireland,166,5,1968,1960.8,161,30,3,1,5,0,0,0,0,1,3,0
Indonesia,150,40,1968,1960.8,110,31,6,5,32,8,6,3,0,2,0,0
Kenya,145,10,1968,1960.8,135,32,4,2,5,5,1,0,1,0,2,2
South Korea,134,13,1968,1960.8,121,33,3,3,7,6,3,1,0,2,0,0
Turkey,115,1,1968,1960.8,114,34,3,2,0,1,0,0,2,2,1,0
Malaysia,111,10,1968,1960.8,101,35,2,4,4,6,1,1,0,3,1,0
Martinique,104,12,1968,1960.8,92,36,3,3,11,1,2,0,1,2,0,1
Guatemala,102,4,1968,1960.8,98,37,2,3,4,0,1,0,0,3,1,0
Uganda,102,13,1968,1960.8,89,38,2,9,3,10,0,1,1,5,1,3
El Salvador,99,17,1968,1960.8,82,39,7,3,16,1,6,0,0,2,1,1
Nigeria,98,17,1968,1960.8,81,40,3,2,12,5,2,2,0,0,1,0
Zambia,97,32,1968,1960.8,65,41,8,5,22,10,5,2,0,2,3,1
Ethiopia,94,14,1968,1960.8,80,42,6,1,14,0,4,0,2,1,0,0
Singapore,92,7,1968,1960.8,85,43,3,5,5,2,2,0,1,5,0,0
Suriname,90,24,1968,1960.8,66,44,4,6,17,7,3,2,0,3,1,1
Israel,89,22,1968,1960.8,67,45,5,5,8,14,2,2,3,2,0,1
Democratic Republic of the Congo,84,11,1968,1960.8,73,46,4,3,5,6,3,2,1,1,0,0
India,68,5,1968,1960.8,63,47,3,2,1,4,0,1,3,0,0,1
Honduras,65,8,1968,1960.8,57,48,4,2,6,2,3,0,0,1,1,1
Myanmar,65,20,1968,1960.8,45,49,11,4,16,4,6,1,3,2,2,1
Greece,63,4,1968,1960.8,59,50,1,1,4,0,1,0,0,1,0,0
Tunisia,63,4,1968,1960.8,59,51,1,4,0,4,0,1,0,2,1,1
Cameroon,60,7,1968,1960.8,53,52,2,1,6,1,1,0,1,0,0,1
Mauritius,57,4,1968,1960.8,53,53,1,1,2,2,0,0,1,0,0,1
Sudan,57,7,1968,1960.8,50,54,1,2,4,3,1,0,0,1,0,1
Hong Kong,53,3,1968,1960.8,50,55,4,3,3,0,0,0,1,3,3,0
Ivory Coast,49,10,1968,1960.8,39,56,1,5,2,8,1,2,0,3,0,0
Tanzania,49,5,1968,1960.8,44,57,2,2,3,2,0,0,1,2,1,0
USA,48,19,1968,1960.8,29,58,3,4,9,10,1,2,1,2,1,0
Guinea,45,12,1968,1960.8,33,59,3,4,5,7,2,1,1,1,0,2
Thailand,30,15,1968,1960.8,15,60,4,6,11,4,3,1,1,3,0,2
Algeria,21,6,1968,1960.8,15,61,3,3,5,1,1,0,2,1,0,2
Burkina Faso,19,6,1968,1960.8,13,62,1,2,2,4,1,1,0,1,0,0
Malawi,15,10,1968,1960.8,5,63,2,2,10,0,1,0,0,2,1,0
Canada,14,4,1968,1960.8,10,64,1,1,4,0,1,0,0,0,0,1
Dominica,12,2,1968,1960.8,10,65,1,1,2,0,0,0,1,1,0,0
Benin,10,2,1968,1960.8,8,66,1,1,2,0,0,0,1,1,0,0
Sierra Leone,9,4,1968,1960.8,5,67,2,1,3,1,1,0,0,1,1,0
Cyprus,7,3,1968,1960.8,4,68,3,1,2,1,1,0,2,1,0,0
New Caledonia,5,5,1968,1960.8,0,69,1,1,2,3,1,1,0,0,0,0
Bermuda,2,2,1968,1960.8,0,70,2,2,0,2,0,0,1,2,1,0
Laos,0,0,1968,1960.8,0,71,1,2,0,0,0,0,1,2,0,0
Hungary,1111,23,1969,1960.9,1088,1,3,7,9,14,3,2,0,3,0,2
Sweden,1106,23,1969,1960.9,1083,2,6,4,16,7,6,3,0,1,0,0
Germany,944,42,1969,1960.9,902,3,10,7,32,10,6,3,1,1,3,3
England,819,24,1969,1960.9,795,4,5,6,13,11,4,4,0,1,1,1
Argentina,781,8,1969,1960.9,773,5,4,4,6,2,2,0,0,2,2,2
Scotland,727,19,1969,1960.9,708,6,3,5,10,9,1,1,0,3,2,1
Austria,713,9,1969,1960.9,704,7,2,4,3,6,1,2,0,1,1,1
Denmark,657,26,1969,1960.9,631,8,6,6,19,7,5,1,1,4,0,1
Belgium,600,4,1969,1960.9,596,9,2,1,4,0,2,0,0,1,0,0
Netherlands,585,9,1969,1960.9,576,10,5,1,8,1,3,0,1,1,1,0
Brazil,568,30,1969,1960.9,538,11,6,3,20,10,6,3,0,0,0,0
Uruguay,536,7,1969,1960.9,529,12,3,4,4,3,2,2,1,1,0,1
Norway,533,18,1969,1960.9,515,13,6,5,10,8,3,1,3,3,0,1
France,515,9,1969,1960.9,506,14,3,3,6,3,2,1,0,2,1,0
Italy,491,13,1969,1960.9,478,15,3,3,7,6,2,1,0,0,1,2
Switzerland,484,4,1969,1960.9,480,16,2,4,1,3,0,1,1,3,1,0
Czech Republic,472,12,1969,1960.9,460,17,3,3,10,2,2,1,0,2,1,0
Wales,384,8,1969,1960.9,376,18,2,5,4,4,0,0,2,3,0,2
Poland,373,29,1969,1960.9,344,19,4,5,19,10,4,2,0,2,0,1
Finland,329,9,1969,1960.9,320,20,3,3,7,2,2,0,0,3,1,0
Paraguay,324,9,1969,1960.9,315,21,5,7,3,6,2,2,2,3,1,2
Northern Ireland,315,2,1969,1960.9,313,22,3,2,1,1,0,0,1,1,2,1
Spain,313,8,1969,1960.9,305,23,3,2,7,1,2,0,0,2,1,0
Chile,273,13,1969,1960.9,260,24,4,7,5,8,1,2,0,3,3,2
Russia,256,13,1969,1960.9,243,25,3,4,5,8,2,2,1,0,0,2
Mexico,239,23,1969,1960.9,216,26,11,8,17,6,5,2,3,4,3,2
Romania,231,6,1969,1960.9,225,27,2,4,2,4,1,1,0,1,1,2
Ghana,228,17,1969,1960.9,211,28,2,2,7,10,1,1,0,1,1,0
Bulgaria,227,10,1969,1960.9,217,29,3,5,6,4,2,1,1,2,0,2
Costa Rica,226,9,1969,1960.9,217,30,3,1,8,1,2,0,0,1,1,0
Curaçao,222,9,1969,1960.9,213,31,1,4,3,6,1,1,0,2,0,1
Portugal,177,3,1969,1960.9,174,32,3,3,2,1,0,0,1,2,2,1
Ireland,170,4,1969,1960.9,166,33,4,3,4,0,0,0,2,3,2,0
Indonesia,169,19,1969,1960.9,150,34,4,1,16,3,3,1,1,0,0,0
Peru,152,24,1969,1960.9,128,35,6,8,10,14,5,3,0,4,1,1
Kenya,148,3,1969,1960.9,145,36,4,2,2,1,1,0,3,1,0,1
South Korea,145,11,1969,1960.9,134,37,6,2,10,1,3,1,1,0,2,1
Turkey,130,15,1969,1960.9,115,38,5,2,13,2,3,1,2,1,0,0
Malaysia,120,9,1969,1960.9,111,39,3,3,6,3,2,0,1,1,0,2
Uganda,119,17,1969,1960.9,102,40,4,2,10,7,4,1,0,1,0,0
Zambia,114,17,1969,1960.9,97,41,3,1,16,1,3,0,0,1,0,0
Ethiopia,112,18,1969,1960.9,94,42,5,3,17,1,3,0,1,3,1,0
El Salvador,111,12,1969,1960.9,99,43,4,4,6,6,2,3,2,1,0,0
Guatemala,111,9,1969,1960.9,102,44,3,1,8,1,1,0,1,0,1,1
Nigeria,109,11,1969,1960.9,98,45,3,4,6,5,2,0,0,2,1,2
Egypt,104,6,1969,1960.9,98,46,3,2,5,1,2,0,1,1,0,1
Suriname,104,14,1969,1960.9,90,47,1,2,2,12,1,2,0,0,0,0
Israel,102,13,1969,1960.9,89,48,5,2,11,2,3,0,0,1,2,1
Singapore,102,10,1969,1960.9,92,49,2,4,7,3,1,0,1,4,0,0
Bolivia,96,5,1969,1960.9,91,50,2,2,5,0,2,0,0,2,0,0
Myanmar,84,19,1969,1960.9,65,51,3,1,18,1,3,0,0,1,0,0
Ecuador,80,6,1969,1960.9,74,52,3,2,5,1,1,0,1,2,1,0
Greece,78,15,1969,1960.9,63,53,3,4,7,8,2,0,0,0,1,4
India,74,6,1969,1960.9,68,54,2,2,3,3,1,0,1,2,0,0
Colombia,73,14,1969,1960.9,59,55,7,6,8,6,1,0,5,4,1,2
Sudan,72,15,1969,1960.9,57,56,4,6,9,6,2,2,0,2,2,2
Honduras,68,3,1969,1960.9,65,57,2,1,3,0,1,0,1,1,0,0
Tunisia,67,4,1969,1960.9,63,58,3,2,3,1,0,0,0,1,3,1
Jamaica,63,7,1969,1960.9,56,59,4,2,5,2,1,1,3,1,0,0
Japan,58,4,1969,1960.9,54,60,1,3,1,3,0,0,1,1,0,2
Ivory Coast,55,6,1969,1960.9,49,61,2,2,5,1,2,0,0,0,0,2
Tanzania,55,6,1969,1960.9,49,62,1,5,1,5,0,2,0,3,1,0
Guinea,54,9,1969,1960.9,45,63,2,2,7,2,1,0,0,0,1,2
Libya,50,3,1969,1960.9,47,64,1,1,2,1,1,0,0,1,0,0
Luxembourg,49,6,1969,1960.9,43,65,3,3,4,2,1,0,2,3,0,0
USA,48,0,1969,1960.9,48,66,1,1,0,0,0,0,1,1,0,0
Haiti,46,12,1969,1960.9,34,67,5,3,7,5,2,2,3,0,0,1
Mali,44,0,1969,1960.9,44,68,1,1,0,0,0,0,0,1,1,0
Iraq,41,4,1969,1960.9,37,69,3,1,3,1,0,0,1,1,2,0
Morocco,40,14,1969,1960.9,26,70,6,8,11,3,4,0,1,5,1,3
Thailand,36,6,1969,1960.9,30,71,3,3,5,1,0,1,1,2,2,0
Algeria,27,6,1969,1960.9,21,72,4,1,6,0,3,0,0,1,1,0
Iceland,26,6,1969,1960.9,20,73,1,3,2,4,1,0,0,3,0,0
Iran,24,15,1969,1960.9,9,74,3,1,15,0,3,0,0,1,0,0
Malawi,23,8,1969,1960.9,15,75,3,6,7,1,1,0,0,5,2,1
New Caledonia,22,17,1969,1960.9,5,76,4,1,6,11,2,1,0,0,2,0
Senegal,19,5,1969,1960.9,14,77,2,3,5,0,2,0,0,3,0,0
Australia,18,11,1969,1960.9,7,78,4,5,4,7,0,2,0,1,4,2
Grenada,13,7,1969,1960.9,6,79,1,1,6,1,1,1,0,0,0,0
Zimbabwe,13,10,1969,1960.9,3,80,3,3,6,4,1,0,0,0,2,3
Venezuela,12,1,1969,1960.9,11,81,3,3,1,0,0,0,2,3,1,0
Cyprus,8,1,1969,1960.9,7,82,1,3,1,0,0,0,1,3,0,0
Bermuda,7,5,1969,1960.9,2,83,2,3,4,1,1,0,1,3,0,0
Niger,7,2,1969,1960.9,5,84,1,2,1,1,0,0,1,1,0,1
Fiji,6,6,1969,1960.9,0,85,2,1,5,1,1,0,1,1,0,0
Laos,5,5,1969,1960.9,0,86,1,3,1,4,0,1,0,2,1,0
Somalia,1,1,1969,1960.9,0,87,1,1,1,0,0,0,1,1,0,0
Hungary,1120,9,1970,1970,1111,1,3,3,4,5,1,2,1,1,1,0
Sweden,1116,10,1970,1970,1106,2,3,7,3,7,2,3,0,1,1,3
Germany,989,45,1970,1970,944,3,11,7,27,18,8,4,1,2,2,1
England,839,20,1970,1970,819,4,5,7,9,11,3,4,1,1,1,2
Argentina,788,7,1970,1970,781,5,1,4,2,5,1,1,0,2,0,1
Scotland,729,2,1970,1970,727,6,3,1,1,1,1,1,0,0,2,0
Austria,717,4,1970,1970,713,7,3,2,3,1,1,0,2,1,0,1
Denmark,659,2,1970,1970,657,8,3,6,0,2,0,0,3,3,0,3
Belgium,608,8,1970,1970,600,9,5,1,8,0,2,0,3,1,0,0
Brazil,604,36,1970,1970,568,10,13,1,31,5,11,1,1,0,1,0
Netherlands,588,3,1970,1970,585,11,1,3,2,1,1,1,0,1,0,1
Uruguay,545,9,1970,1970,536,12,2,7,4,5,2,2,0,4,0,1
Norway,539,6,1970,1970,533,13,3,4,3,3,1,1,2,2,0,1
France,527,12,1970,1970,515,14,4,3,9,3,3,1,0,2,1,0
Italy,511,20,1970,1970,491,15,3,8,4,16,2,4,0,1,1,3
Switzerland,490,6,1970,1970,484,16,4,2,3,3,1,2,2,0,1,0
Czech Republic,486,14,1970,1970,472,17,4,7,4,10,0,4,2,3,2,0
Poland,392,19,1970,1970,373,18,5,5,13,6,4,2,0,2,1,1
Wales,386,2,1970,1970,384,19,3,1,2,0,1,0,0,0,2,1
Finland,332,3,1970,1970,329,20,2,3,2,1,0,0,1,2,1,1
Paraguay,325,1,1970,1970,324,21,1,1,1,0,0,0,0,0,1,1
Spain,323,10,1970,1970,313,22,4,1,9,1,3,1,0,0,1,0
Northern Ireland,316,1,1970,1970,315,23,1,3,0,1,0,0,1,3,0,0
Chile,275,2,1970,1970,273,24,1,2,1,1,0,0,1,2,0,0
Russia,272,16,1970,1970,256,25,1,10,0,16,0,5,1,0,0,5
Mexico,260,21,1970,1970,239,26,12,3,19,2,5,1,2,2,5,0
Bulgaria,244,17,1970,1970,227,27,6,5,9,8,0,1,2,2,4,2
Romania,240,9,1970,1970,231,28,1,8,3,6,1,1,0,4,0,3
Ghana,238,10,1970,1970,228,29,4,3,7,3,2,1,0,1,2,1
Curaçao,224,2,1970,1970,222,30,1,1,1,1,0,0,0,1,1,0
Indonesia,203,34,1970,1970,169,31,12,2,30,4,6,1,5,1,1,0
South Korea,180,35,1970,1970,145,32,8,9,22,13,5,5,2,0,1,4
Portugal,179,2,1970,1970,177,33,1,1,1,1,0,1,1,0,0,0
Peru,178,26,1970,1970,152,34,10,7,13,13,4,2,4,4,2,1
Ireland,173,3,1970,1970,170,35,2,4,1,2,0,0,1,4,1,0
Kenya,149,1,1970,1970,148,36,1,1,1,0,0,0,1,1,0,0
Malaysia,138,18,1970,1970,120,37,3,8,7,11,1,4,2,2,0,2
Turkey,137,7,1970,1970,130,38,1,3,2,5,1,1,0,0,0,2
Uganda,127,8,1970,1970,119,39,2,3,2,6,0,2,1,1,1,0
Ethiopia,116,4,1970,1970,112,40,2,2,2,2,0,0,2,2,0,0
Egypt,115,11,1970,1970,104,41,3,3,8,3,2,2,0,1,1,0
Singapore,114,12,1970,1970,102,42,2,10,7,5,0,1,2,9,0,0
El Salvador,111,0,1970,1970,111,43,2,4,0,0,0,0,2,4,0,0
Nigeria,110,1,1970,1970,109,44,1,1,0,1,0,0,0,1,1,0
Israel,108,6,1970,1970,102,45,4,1,1,5,0,1,2,0,2,0
Democratic Republic of the Congo,94,10,1970,1970,84,46,5,1,6,4,2,1,2,0,1,0
Myanmar,94,10,1970,1970,84,47,4,1,8,2,2,1,1,0,1,0
India,87,13,1970,1970,74,48,2,3,2,11,0,2,2,1,0,0
Ecuador,82,2,1970,1970,80,49,1,1,0,2,0,0,1,1,0,0
Greece,82,4,1970,1970,78,50,3,2,2,2,0,0,2,1,1,1
Sudan,80,8,1970,1970,72,51,5,1,8,0,4,0,1,1,0,0
Guinea,76,22,1970,1970,54,52,5,5,14,8,5,1,0,2,0,2
Ivory Coast,75,20,1970,1970,55,53,3,9,4,16,2,3,1,5,0,1
Tunisia,73,6,1970,1970,67,54,1,2,2,4,1,0,0,1,0,1
Hong Kong,72,19,1970,1970,53,55,10,4,15,4,4,0,4,4,2,0
Japan,71,13,1970,1970,58,56,4,2,8,5,2,1,0,1,2,0
Cameroon,68,8,1970,1970,60,57,3,2,6,2,2,0,1,1,0,1
Mauritius,62,5,1970,1970,57,58,1,3,4,1,1,0,0,2,0,1
Congo,61,4,1970,1970,57,59,1,2,2,2,1,0,0,1,0,1
Tanzania,60,5,1970,1970,55,60,2,2,3,2,1,0,1,1,0,1
Thailand,58,22,1970,1970,36,61,6,7,8,14,4,3,1,2,1,2
Libya,55,5,1970,1970,50,62,3,1,5,0,1,0,1,1,1,0
Luxembourg,50,1,1970,1970,49,63,2,1,0,1,0,0,2,0,0,1
Mali,49,5,1970,1970,44,64,1,2,3,2,1,1,0,1,0,0
Morocco,46,6,1970,1970,40,65,2,3,3,3,1,0,1,2,0,1
Madagascar,36,3,1970,1970,33,66,1,1,2,1,1,0,0,1,0,0
Malawi,32,9,1970,1970,23,67,4,1,8,1,2,0,1,1,1,0
Algeria,30,3,1970,1970,27,68,1,1,3,0,1,0,0,1,0,0
Senegal,25,6,1970,1970,19,69,1,6,4,2,1,1,0,5,0,0
Kuwait,23,10,1970,1970,13,70,1,2,4,6,1,2,0,0,0,0
Pakistan,20,1,1970,1970,19,71,1,1,1,0,0,0,1,1,0,0
Togo,19,5,1970,1970,14,72,2,1,5,0,2,0,0,0,0,1
Benin,14,4,1970,1970,10,73,2,1,3,1,1,0,0,1,1,0
Dominica,14,2,1970,1970,12,74,1,1,1,1,0,0,0,1,1,0
Cambodia,11,2,1970,1970,9,75,1,1,1,1,0,0,0,1,1,0
Niger,11,4,1970,1970,7,76,1,2,0,4,0,0,1,1,0,1
Cyprus,10,2,1970,1970,8,77,1,1,1,1,0,0,1,0,0,1
Gabon,10,5,1970,1970,5,78,2,2,2,3,0,1,1,1,1,0
Laos,10,5,1970,1970,5,79,1,3,3,2,1,0,0,3,0,0
Saudi Arabia,2,2,1970,1970,0,80,2,1,2,0,0,0,1,0,1,1
Hungary,1133,13,1971,1970.1,1120,1,3,4,7,6,2,3,0,1,1,0
Sweden,1128,12,1971,1970.1,1116,2,5,3,9,3,4,1,0,2,1,0
Germany,1025,36,1971,1970.1,989,3,6,11,11,25,3,8,0,2,3,1
England,858,19,1971,1970.1,839,4,5,4,12,7,3,4,0,0,2,0
Argentina,803,15,1971,1970.1,788,5,7,3,11,4,4,0,1,0,2,3
Scotland,734,5,1971,1970.1,729,6,3,7,3,2,2,0,1,6,0,1
Austria,731,14,1971,1970.1,717,7,3,4,7,7,2,1,1,1,0,2
Denmark,670,11,1971,1970.1,659,8,6,2,7,4,2,1,3,1,1,0
Belgium,622,14,1971,1970.1,608,9,3,4,7,7,3,2,0,1,0,1
Brazil,610,6,1971,1970.1,604,10,3,2,3,3,2,0,0,0,1,2
Uruguay,550,5,1971,1970.1,545,11,4,2,5,0,1,0,1,2,2,0
Norway,547,8,1971,1970.1,539,12,5,3,7,1,1,0,4,2,0,1
France,540,13,1971,1970.1,527,13,2,6,2,11,1,2,1,2,0,2
Italy,521,10,1971,1970.1,511,14,4,2,8,2,2,1,1,0,1,1
Switzerland,505,15,1971,1970.1,490,15,5,1,14,1,3,0,2,0,0,1
Czech Republic,497,11,1971,1970.1,486,16,2,5,2,9,2,2,0,2,0,1
Poland,403,11,1971,1970.1,392,17,2,4,6,5,1,1,1,1,0,2
Wales,391,5,1971,1970.1,386,18,3,5,4,1,1,1,1,3,1,1
Spain,337,14,1971,1970.1,323,19,3,3,9,5,1,2,0,1,2,0
Finland,334,2,1971,1970.1,332,20,4,3,1,1,0,0,3,2,1,1
Paraguay,332,7,1971,1970.1,325,21,3,4,5,2,2,0,0,3,1,1
Northern Ireland,327,11,1971,1970.1,316,22,4,3,7,4,2,2,1,1,1,0
Chile,290,15,1971,1970.1,275,23,5,5,11,4,3,1,1,4,1,0
Russia,290,18,1971,1970.1,272,24,5,6,15,3,5,1,0,0,0,5
Mexico,269,9,1971,1970.1,260,25,4,9,1,8,0,5,1,2,3,2
Bulgaria,258,14,1971,1970.1,244,26,4,4,8,6,2,2,0,2,2,0
Indonesia,248,45,1971,1970.1,203,27,14,12,32,13,10,3,1,8,3,1
Romania,248,8,1971,1970.1,240,28,2,2,4,4,2,1,0,1,0,0
Ghana,247,9,1971,1970.1,238,29,3,1,3,6,0,1,2,0,1,0
South Korea,200,20,1971,1970.1,180,30,11,4,16,4,5,2,3,1,3,1
Portugal,188,9,1971,1970.1,179,31,3,2,8,1,2,0,0,2,1,0
Peru,179,1,1971,1970.1,178,32,2,2,1,0,1,0,0,2,1,0
Malaysia,176,38,1971,1970.1,138,33,7,14,20,18,5,3,1,8,1,3
Ireland,175,2,1971,1970.1,173,34,2,1,2,0,0,0,2,1,0,0
Kenya,165,16,1971,1970.1,149,35,7,4,12,4,4,2,1,1,2,1
Zambia,154,40,1971,1970.1,114,36,11,7,26,14,8,3,3,4,0,0
Myanmar,145,51,1971,1970.1,94,37,13,4,49,2,11,1,1,0,1,3
Turkey,139,2,1971,1970.1,137,38,2,3,1,1,1,0,1,3,0,0
Singapore,132,18,1971,1970.1,114,39,4,9,8,10,2,2,1,4,1,3
Uganda,132,5,1971,1970.1,127,40,2,3,3,2,0,1,0,2,2,0
Egypt,120,5,1971,1970.1,115,41,2,2,3,2,2,1,0,1,0,0
China,119,6,1971,1970.1,113,42,1,2,1,5,1,1,0,0,0,1
Nigeria,116,6,1971,1970.1,110,43,2,2,5,1,2,1,0,1,0,0
Guatemala,112,1,1971,1970.1,111,44,1,1,1,0,0,0,0,1,1,0
Martinique,109,5,1971,1970.1,104,45,2,1,4,1,1,0,0,0,1,1
India,107,20,1971,1970.1,87,46,7,3,18,2,3,0,3,3,1,0
Democratic Republic of the Congo,100,6,1971,1970.1,94,47,1,3,3,3,1,1,0,1,0,1
Guinea,97,21,1971,1970.1,76,48,4,5,11,10,4,1,0,3,0,1
Thailand,91,33,1971,1970.1,58,49,8,13,19,14,5,6,2,6,1,1
Sudan,90,10,1971,1970.1,80,50,1,2,1,9,0,1,0,0,1,1
Greece,87,5,1971,1970.1,82,51,4,4,2,3,1,0,3,2,0,2
Hong Kong,86,14,1971,1970.1,72,52,5,4,11,3,3,0,2,4,0,0
Ivory Coast,80,5,1971,1970.1,75,53,2,1,5,0,1,0,1,1,0,0
Cameroon,77,9,1971,1970.1,68,54,3,1,9,0,1,0,1,1,1,0
Tanzania,74,14,1971,1970.1,60,55,5,3,11,3,2,0,2,1,1,2
Honduras,73,5,1971,1970.1,68,56,2,3,2,3,1,0,1,2,0,1
Congo,66,5,1971,1970.1,61,57,1,2,2,3,1,0,0,2,0,0
Haiti,65,19,1971,1970.1,46,58,3,4,11,8,2,1,0,0,1,3
Libya,65,10,1971,1970.1,55,59,5,2,8,2,2,1,2,1,1,0
Mauritius,64,2,1971,1970.1,62,60,1,3,0,2,0,0,0,2,1,1
Jamaica,63,0,1971,1970.1,63,61,1,1,0,0,0,0,1,0,0,1
Iraq,60,19,1971,1970.1,41,62,5,3,15,4,5,2,0,0,0,1
Guadeloupe,56,2,1971,1970.1,54,63,1,1,1,1,0,0,0,1,1,0
Luxembourg,51,1,1971,1970.1,50,64,1,4,0,1,0,0,1,4,0,0
Malawi,46,14,1971,1970.1,32,65,5,3,9,5,2,1,3,0,0,2
Madagascar,44,8,1971,1970.1,36,66,3,1,6,2,2,1,0,0,1,0
New Caledonia,37,15,1971,1970.1,22,67,4,1,10,5,3,1,0,0,1,0
Senegal,37,12,1971,1970.1,25,68,4,3,9,3,3,1,0,1,1,1
Kuwait,30,7,1971,1970.1,23,69,6,1,6,1,2,0,2,1,2,0
Cambodia,28,17,1971,1970.1,11,70,7,6,13,4,3,0,3,5,1,1
Lebanon,28,6,1971,1970.1,22,71,2,3,5,1,2,0,0,3,0,0
Iceland,27,1,1971,1970.1,26,72,1,1,0,1,0,0,1,1,0,0
Fiji,26,20,1971,1970.1,6,73,2,1,5,15,0,1,2,0,0,0
Togo,22,3,1971,1970.1,19,74,2,1,1,2,1,1,1,0,0,0
Cuba,21,4,1971,1970.1,17,75,4,2,3,1,1,1,1,1,2,0
Burkina Faso,20,1,1971,1970.1,19,76,1,2,1,0,0,0,1,2,0,0
Syria,19,5,1971,1970.1,14,77,1,4,0,5,0,0,0,3,1,1
Grenada,18,5,1971,1970.1,13,78,1,1,5,0,1,0,0,1,0,0
Sierra Leone,17,8,1971,1970.1,9,79,2,4,3,5,1,2,1,2,0,0
Bahrain,15,8,1971,1970.1,7,80,2,2,6,2,2,0,0,2,0,0
Jordan,14,5,1971,1970.1,9,81,2,4,5,0,2,0,0,3,0,1
Albania,13,4,1971,1970.1,9,82,3,1,4,0,1,0,1,1,1,0
Cyprus,11,1,1971,1970.1,10,83,2,6,0,1,0,0,2,6,0,0
Philippines,10,10,1971,1970.1,0,84,3,4,7,3,1,0,1,4,1,0
Malta,5,1,1971,1970.1,4,85,3,3,1,0,0,0,2,3,1,0
Sweden,1146,18,1972,1970.2,1128,1,5,3,14,4,2,1,1,1,2,1
Hungary,1144,11,1972,1970.2,1133,2,5,5,6,5,2,0,2,2,1,3
Germany,1054,29,1972,1970.2,1025,3,7,5,18,11,5,4,0,1,2,0
England,864,6,1972,1970.2,858,4,2,4,1,5,0,3,2,0,0,1
Argentina,816,13,1972,1970.2,803,5,6,3,7,6,3,2,1,1,2,0
Austria,745,14,1972,1970.2,731,6,3,4,8,6,2,1,0,1,1,2
Scotland,745,11,1972,1970.2,734,7,5,3,7,4,4,1,1,1,0,1
Denmark,680,10,1972,1970.2,670,8,3,3,5,5,1,1,1,2,1,0
Belgium,637,15,1972,1970.2,622,9,6,2,13,2,4,1,1,0,1,1
Netherlands,607,19,1972,1970.2,588,10,2,3,12,7,2,2,0,0,0,1
Norway,553,6,1972,1970.2,547,11,4,3,5,1,1,0,3,2,0,1
Uruguay,552,2,1972,1970.2,550,12,1,6,0,2,0,1,1,3,0,2
France,548,8,1972,1970.2,540,13,1,5,1,7,1,2,0,2,0,1
Italy,531,10,1972,1970.2,521,14,1,6,0,10,0,1,0,2,1,3
Czech Republic,509,12,1972,1970.2,497,15,5,3,10,2,2,1,2,1,1,1
Switzerland,508,3,1972,1970.2,505,16,2,3,1,2,0,0,0,1,2,2
Wales,391,0,1972,1970.2,391,17,3,1,0,0,0,0,2,1,1,0
Paraguay,345,13,1972,1970.2,332,18,2,3,5,8,2,1,0,1,0,1
Spain,342,5,1972,1970.2,337,19,3,2,4,1,3,0,0,0,0,2
Finland,337,3,1972,1970.2,334,20,4,2,3,0,1,0,0,2,3,0
Northern Ireland,329,2,1972,1970.2,327,21,1,4,1,1,0,1,0,2,1,1
Russia,304,14,1972,1970.2,290,22,2,11,3,11,2,3,0,5,0,3
Chile,300,10,1972,1970.2,290,23,6,2,10,0,3,0,3,2,0,0
Mexico,288,19,1972,1970.2,269,24,5,5,12,7,5,3,0,2,0,0
Indonesia,270,22,1972,1970.2,248,25,12,5,15,7,5,1,4,3,3,1
Bulgaria,267,9,1972,1970.2,258,26,3,2,5,4,1,1,0,1,2,0
Ghana,263,16,1972,1970.2,247,27,3,3,8,8,1,1,1,1,1,1
Romania,263,15,1972,1970.2,248,28,6,3,12,3,2,0,0,1,4,2
South Korea,239,39,1972,1970.2,200,29,14,10,23,16,8,4,3,2,3,4
Costa Rica,236,10,1972,1970.2,226,30,4,4,7,3,2,1,0,2,2,1
Portugal,210,22,1972,1970.2,188,31,3,7,6,16,2,6,0,1,1,0
Malaysia,193,17,1972,1970.2,176,32,4,11,5,12,1,5,2,5,1,1
Peru,190,11,1972,1970.2,179,33,3,8,4,7,2,1,1,5,0,2
Ireland,185,10,1972,1970.2,175,34,3,3,4,6,1,2,2,1,0,0
Kenya,180,15,1972,1970.2,165,35,6,5,9,6,2,2,1,3,3,0
Myanmar,167,22,1972,1970.2,145,36,8,2,21,1,5,1,1,1,2,0
Zambia,165,11,1972,1970.2,154,37,2,3,9,2,1,0,0,0,1,3
Singapore,164,32,1972,1970.2,132,38,6,15,16,16,3,5,3,8,0,2
Trinidad and Tobago,154,23,1972,1970.2,131,39,3,4,14,9,2,4,0,0,1,0
Nigeria,148,32,1972,1970.2,116,40,8,7,21,11,7,3,0,1,1,3
Turkey,142,3,1972,1970.2,139,41,1,2,3,0,1,0,0,2,0,0
Uganda,142,10,1972,1970.2,132,42,2,3,5,5,1,2,0,1,1,0
China,136,17,1972,1970.2,119,43,1,6,6,11,1,3,0,0,0,3
Egypt,125,5,1972,1970.2,120,44,3,2,5,0,2,0,0,1,1,1
Ethiopia,120,4,1972,1970.2,116,45,3,1,3,1,1,0,1,0,1,1
Thailand,120,29,1972,1970.2,91,46,10,11,14,15,3,3,4,5,3,3
Democratic Republic of the Congo,119,19,1972,1970.2,100,47,2,6,10,9,2,1,0,2,0,3
Guatemala,117,5,1972,1970.2,112,48,3,2,3,2,1,1,0,0,2,1
El Salvador,111,0,1972,1970.2,111,49,2,2,0,0,0,0,2,2,0,0
Guinea,108,11,1972,1970.2,97,50,3,5,6,5,1,1,1,2,1,2
Hong Kong,101,15,1972,1970.2,86,51,7,1,13,2,4,1,1,0,2,0
Sudan,95,5,1972,1970.2,90,52,2,5,2,3,1,0,0,4,1,1
Greece,91,4,1972,1970.2,87,53,4,1,3,1,1,1,2,0,1,0
Haiti,91,26,1972,1970.2,65,54,4,3,15,11,4,1,0,0,0,2
Congo,87,21,1972,1970.2,66,55,7,5,13,8,2,3,1,2,4,0
Japan,87,16,1972,1970.2,71,56,5,1,16,0,3,0,1,1,1,0
Ecuador,86,4,1972,1970.2,82,57,3,1,3,1,0,0,2,1,1,0
Ivory Coast,85,5,1972,1970.2,80,58,1,2,2,3,1,2,0,0,0,0
Tanzania,85,11,1972,1970.2,74,59,3,7,4,7,1,1,0,3,2,3
Tunisia,83,10,1972,1970.2,73,60,4,1,9,1,2,0,1,1,1,0
Honduras,78,5,1972,1970.2,73,61,1,1,2,3,1,0,0,0,0,1
Colombia,77,4,1972,1970.2,73,62,2,1,3,1,0,0,1,1,1,0
Iraq,70,10,1972,1970.2,60,63,4,3,9,1,3,0,0,1,1,2
Panama,70,5,1972,1970.2,65,64,2,1,5,0,1,0,1,0,0,1
Mauritius,69,5,1972,1970.2,64,65,3,1,3,2,0,0,3,0,0,1
Jamaica,68,5,1972,1970.2,63,66,1,2,2,3,1,1,0,0,0,1
Mali,62,13,1972,1970.2,49,67,3,4,9,4,2,0,0,2,1,2
New Zealand,60,9,1972,1970.2,51,68,2,3,6,3,2,0,0,2,0,1
Cambodia,56,28,1972,1970.2,28,69,12,6,20,8,6,1,4,4,2,1
Kuwait,54,24,1972,1970.2,30,70,3,7,15,9,3,3,0,3,0,1
Morocco,54,8,1972,1970.2,46,71,3,4,2,6,0,2,0,1,3,1
USA,54,6,1972,1970.2,48,72,2,2,3,3,0,0,1,2,1,0
Luxembourg,53,2,1972,1970.2,51,73,2,2,2,0,1,0,1,2,0,0
Madagascar,47,3,1972,1970.2,44,74,1,1,0,3,0,1,1,0,0,0
Algeria,46,16,1972,1970.2,30,75,7,4,11,5,6,1,1,3,0,0
New Caledonia,42,5,1972,1970.2,37,76,1,2,3,2,1,0,0,2,0,0
Iran,39,15,1972,1970.2,24,77,6,3,10,5,4,1,2,1,0,1
Senegal,39,2,1972,1970.2,37,78,4,1,2,0,0,0,3,0,1,1
Australia,34,16,1972,1970.2,18,79,1,4,3,13,1,3,0,0,0,1
Iceland,33,6,1972,1970.2,27,80,2,3,5,1,1,0,1,3,0,0
Togo,32,10,1972,1970.2,22,81,2,5,4,6,1,0,0,2,1,3
Syria,27,8,1972,1970.2,19,82,1,3,3,5,1,2,0,1,0,0
Bahrain,24,9,1972,1970.2,15,83,3,1,8,1,2,0,1,1,0,0
Sri Lanka,23,13,1972,1970.2,10,84,2,9,2,11,0,1,2,8,0,0
Benin,22,8,1972,1970.2,14,85,2,4,5,3,1,0,1,3,0,1
Canada,22,8,1972,1970.2,14,86,2,3,3,5,1,0,1,1,0,2
Sierra Leone,22,5,1972,1970.2,17,87,4,2,5,0,1,0,2,2,1,0
Palestine,21,8,1972,1970.2,13,88,2,1,8,0,1,0,1,1,0,0
Philippines,21,11,1972,1970.2,10,89,6,6,7,4,3,0,3,5,0,1
Dominica,15,1,1972,1970.2,14,90,1,1,1,0,0,0,1,1,0,0
Laos,13,3,1972,1970.2,10,91,2,1,2,1,0,0,2,1,0,0
Cyprus,11,0,1972,1970.2,11,92,2,1,0,0,0,0,2,1,0,0
Qatar,6,6,1972,1970.2,0,93,1,6,0,6,0,0,1,6,0,0
Malta,5,0,1972,1970.2,5,94,1,4,0,0,0,0,1,4,0,0
Antigua and Barbuda,3,3,1972,1970.2,0,95,3,1,2,1,0,0,3,1,0,0
Lesotho,3,3,1972,1970.2,0,96,3,3,2,1,0,0,0,3,3,0
Puerto Rico,1,1,1972,1970.2,0,97,2,3,0,1,0,1,1,2,1,0
Sweden,1163,17,1973,1970.3,1146,1,4,7,6,11,3,4,0,1,1,2
Hungary,1152,8,1973,1970.3,1144,2,3,2,5,3,0,0,1,1,2,1
Germany,1096,42,1973,1970.3,1054,3,11,11,23,19,9,7,2,2,0,2
England,887,23,1973,1970.3,864,4,7,5,15,8,4,2,1,2,2,1
Argentina,840,24,1973,1970.3,816,5,5,7,16,8,4,2,0,2,1,3
Austria,752,7,1973,1970.3,745,6,3,4,3,4,1,0,1,3,1,1
Scotland,751,6,1973,1970.3,745,7,5,4,4,2,1,1,3,3,1,0
Denmark,686,6,1973,1970.3,680,8,4,3,5,1,1,1,1,2,2,0
Belgium,642,5,1973,1970.3,637,9,2,1,5,0,2,0,0,0,0,1
Brazil,629,19,1973,1970.3,610,10,1,9,5,14,1,6,0,2,0,1
Netherlands,626,19,1973,1970.3,607,11,5,2,17,2,3,1,0,1,2,0
Uruguay,562,10,1973,1970.3,552,12,3,5,5,5,1,2,1,0,1,3
Norway,559,6,1973,1970.3,553,13,3,3,2,4,0,1,2,2,1,0
France,557,9,1973,1970.3,548,14,4,2,8,1,2,0,1,2,1,0
Italy,546,15,1973,1970.3,531,15,6,2,13,2,5,2,0,0,1,0
Czech Republic,519,10,1973,1970.3,509,16,3,3,8,2,2,0,0,2,1,1
Switzerland,511,3,1973,1970.3,508,17,3,3,2,1,2,1,0,2,1,0
Poland,429,26,1973,1970.3,403,18,4,11,11,15,4,6,0,3,0,2
Wales,394,3,1973,1970.3,391,19,2,4,2,1,1,0,1,3,0,1
Paraguay,355,10,1973,1970.3,345,20,3,4,6,4,1,1,0,2,2,1
Spain,351,9,1973,1970.3,342,21,1,4,3,6,1,1,0,2,0,1
Finland,340,3,1973,1970.3,337,22,2,3,2,1,0,0,2,2,0,1
Northern Ireland,338,9,1973,1970.3,329,23,4,4,5,4,2,1,0,2,2,1
Chile,318,18,1973,1970.3,300,24,4,6,10,8,4,1,0,2,0,3
Russia,310,6,1973,1970.3,304,25,8,2,6,0,3,0,3,2,2,0
Mexico,304,16,1973,1970.3,288,26,7,3,14,2,3,1,4,0,0,2
Bulgaria,297,30,1973,1970.3,267,27,4,11,5,25,3,5,1,2,0,4
Indonesia,281,11,1973,1970.3,270,28,6,5,6,5,2,0,2,4,2,1
Romania,277,14,1973,1970.3,263,29,2,3,10,4,2,1,0,2,0,0
South Korea,271,32,1973,1970.3,239,30,13,4,25,7,8,2,1,1,4,1
Ghana,268,5,1973,1970.3,263,31,3,4,1,4,1,1,1,3,1,0
Curaçao,231,7,1973,1970.3,224,32,3,4,3,4,0,0,1,2,2,2
Malaysia,217,24,1973,1970.3,193,33,5,13,12,12,4,4,0,6,1,3
Portugal,217,7,1973,1970.3,210,34,2,3,3,4,0,1,0,1,2,1
Peru,210,20,1973,1970.3,190,35,6,5,17,3,6,0,0,4,0,1
Myanmar,192,25,1973,1970.3,167,36,9,6,16,9,4,2,2,3,3,1
Ireland,191,6,1973,1970.3,185,37,2,4,4,2,1,0,1,2,0,2
Kenya,189,9,1973,1970.3,180,38,5,1,9,0,1,0,2,1,2,0
Zambia,188,23,1973,1970.3,165,39,4,10,10,13,3,1,1,6,0,3
Singapore,177,13,1973,1970.3,164,40,2,9,4,9,0,1,2,6,0,2
Trinidad and Tobago,169,15,1973,1970.3,154,41,1,7,2,13,1,3,0,3,0,1
Uganda,164,22,1973,1970.3,142,42,6,3,16,6,5,1,0,1,1,1
China,156,20,1973,1970.3,136,43,3,1,19,1,3,0,0,0,0,1
Turkey,153,11,1973,1970.3,142,44,5,2,11,0,3,0,1,0,1,2
Nigeria,150,2,1973,1970.3,148,45,1,1,2,0,0,0,1,0,0,1
Democratic Republic of the Congo,145,26,1973,1970.3,119,46,7,5,17,9,6,3,1,2,0,0
Thailand,142,22,1973,1970.3,120,47,6,8,11,11,4,2,2,4,0,2
Israel,127,19,1973,1970.3,108,48,8,2,19,0,6,0,1,1,1,1
Ethiopia,122,2,1973,1970.3,120,49,1,2,0,2,0,0,0,2,1,0
Guatemala,122,5,1973,1970.3,117,50,4,2,3,2,0,0,1,2,3,0
Haiti,121,30,1973,1970.3,91,51,17,3,25,5,10,1,4,2,3,0
India,114,7,1973,1970.3,107,52,1,1,2,5,1,1,0,0,0,0
Guinea,111,3,1973,1970.3,108,53,2,2,1,2,0,0,0,2,2,0
Hong Kong,104,3,1973,1970.3,101,54,1,2,1,2,1,1,0,1,0,0
Tunisia,104,21,1973,1970.3,83,55,2,8,2,19,0,6,1,1,1,1
Bolivia,103,7,1973,1970.3,96,56,5,6,7,0,1,0,2,5,2,1
Ivory Coast,98,13,1973,1970.3,85,57,4,4,6,7,3,1,0,2,1,1
Greece,97,6,1973,1970.3,91,58,2,2,4,2,0,0,1,2,1,0
Ecuador,96,10,1973,1970.3,86,59,5,5,4,6,0,1,1,2,4,2
Congo,92,5,1973,1970.3,87,60,2,2,3,2,1,0,1,2,0,0
Tanzania,91,6,1973,1970.3,85,61,1,3,2,4,1,1,0,2,0,0
Japan,88,1,1973,1970.3,87,62,1,3,0,1,0,0,1,3,0,0
Iraq,86,16,1973,1970.3,70,63,7,5,15,1,5,0,1,1,1,4
Colombia,84,7,1973,1970.3,77,64,3,5,1,6,0,2,1,2,2,1
Honduras,84,6,1973,1970.3,78,65,3,2,5,1,1,0,0,1,2,1
Cameroon,80,3,1973,1970.3,77,66,2,3,2,1,1,1,1,2,0,0
New Zealand,75,15,1973,1970.3,60,67,5,5,11,4,3,0,0,3,2,2
Kuwait,74,20,1973,1970.3,54,68,3,8,15,5,3,1,0,6,0,1
Panama,72,2,1973,1970.3,70,69,1,1,2,0,1,0,0,1,0,0
Mauritius,71,2,1973,1970.3,69,70,1,2,1,1,0,0,0,2,1,0
Algeria,67,21,1973,1970.3,46,71,7,2,19,2,3,1,1,1,3,0
Morocco,67,13,1973,1970.3,54,72,4,5,11,2,4,0,0,3,0,2
Cambodia,65,9,1973,1970.3,56,73,6,3,6,3,1,1,4,1,1,1
USA,59,5,1973,1970.3,54,74,4,8,2,3,2,1,2,7,0,0
Australia,58,24,1973,1970.3,34,75,11,3,21,3,5,0,2,1,4,2
New Caledonia,54,12,1973,1970.3,42,76,3,2,9,3,2,1,1,1,0,0
Luxembourg,53,0,1973,1970.3,53,77,2,2,0,0,0,0,2,2,0,0
Malawi,52,6,1973,1970.3,46,78,2,1,5,1,2,1,0,0,0,0
Iran,46,7,1973,1970.3,39,79,5,2,7,0,4,0,1,1,0,1
Senegal,42,3,1973,1970.3,39,80,1,2,1,2,1,0,0,2,0,0
Iceland,39,6,1973,1970.3,33,81,3,4,1,5,0,1,3,3,0,0
Syria,35,8,1973,1970.3,27,82,4,4,5,3,2,2,2,1,0,1
Fiji,28,2,1973,1970.3,26,83,2,1,1,1,0,0,2,1,0,0
Canada,27,5,1973,1970.3,22,84,2,5,1,4,0,2,2,2,0,1
Grenada,26,8,1973,1970.3,18,85,2,2,3,5,1,1,0,1,1,0
Palestine,23,2,1973,1970.3,21,86,1,1,2,0,0,0,1,1,0,0
Dominica,22,7,1973,1970.3,15,87,2,2,5,2,2,0,0,1,0,1
Burkina Faso,21,1,1973,1970.3,20,88,1,1,0,1,0,0,1,1,0,0
Albania,17,4,1973,1970.3,13,89,4,1,4,0,1,0,2,1,1,0
Laos,17,4,1973,1970.3,13,90,1,2,3,1,1,0,0,2,0,0
Cyprus,12,1,1973,1970.3,11,91,2,2,1,0,1,0,1,2,0,0
Bermuda,11,4,1973,1970.3,7,92,1,1,4,0,1,0,0,1,0,0
Somalia,7,6,1973,1970.3,1,93,1,2,1,5,0,0,1,2,0,0
Central African Republic,6,5,1973,1970.3,1,94,1,1,4,1,1,0,0,1,0,0
Bangladesh,5,5,1973,1970.3,0,95,5,1,4,1,0,1,3,0,2,0
St. Lucia,3,3,1973,1970.3,0,96,2,2,3,0,1,0,1,2,0,0
Sweden,1173,10,1974,1970.4,1163,1,7,5,6,4,2,1,3,3,2,1
Hungary,1160,8,1974,1970.4,1152,2,2,5,4,4,2,1,0,3,0,1
Germany,1146,50,1974,1970.4,1096,3,18,15,29,21,13,6,2,4,3,5
England,897,10,1974,1970.4,887,4,4,5,6,4,2,2,0,1,2,2
Argentina,859,19,1974,1970.4,840,5,7,6,11,8,2,2,1,3,4,1
Scotland,765,14,1974,1970.4,751,6,6,4,8,6,3,2,2,2,1,0
Austria,757,5,1974,1970.4,752,7,3,3,3,2,2,1,0,0,1,2
Denmark,701,15,1974,1970.4,686,8,5,3,12,3,2,1,2,1,1,1
Netherlands,658,32,1974,1970.4,626,9,8,6,15,17,5,5,0,1,3,0
Belgium,650,8,1974,1970.4,642,10,3,4,5,3,2,2,0,1,1,1
Brazil,648,19,1974,1970.4,629,11,11,4,14,5,7,2,1,1,3,1
Uruguay,573,11,1974,1970.4,562,12,2,7,2,9,1,3,1,2,0,2
France,566,9,1974,1970.4,557,13,3,3,3,6,1,1,1,1,1,1
Norway,564,5,1974,1970.4,559,14,3,2,4,1,1,0,2,2,0,0
Italy,552,6,1974,1970.4,546,15,3,4,3,3,1,0,0,2,2,2
Czech Republic,534,15,1974,1970.4,519,16,4,6,12,3,2,3,0,3,2,0
Switzerland,516,5,1974,1970.4,511,17,3,4,4,1,1,0,2,3,0,1
Poland,460,31,1974,1970.4,429,18,7,9,13,18,5,5,2,2,0,2
Wales,403,9,1974,1970.4,394,19,4,2,8,1,3,0,1,2,0,0
Spain,357,6,1974,1970.4,351,20,1,3,1,5,1,2,0,0,0,1
Finland,347,7,1974,1970.4,340,21,3,3,3,4,0,1,2,1,1,1
Chile,323,5,1974,1970.4,318,22,4,5,3,2,1,1,2,1,1,3
Bulgaria,318,21,1974,1970.4,297,23,8,8,10,11,1,3,3,3,4,2
Russia,310,0,1974,1970.4,310,24,1,1,0,0,0,0,1,1,0,0
Mexico,309,5,1974,1970.4,304,25,1,2,3,2,1,1,0,0,0,1
Indonesia,301,20,1974,1970.4,281,26,8,3,18,2,3,0,5,1,0,2
South Korea,283,12,1974,1970.4,271,27,4,4,3,9,1,3,1,1,2,0
Romania,282,5,1974,1970.4,277,28,1,7,3,2,1,1,0,3,0,3
Ghana,280,12,1974,1970.4,268,29,3,3,9,3,2,1,0,0,1,2
Malaysia,235,18,1974,1970.4,217,30,4,9,7,11,2,2,0,3,2,4
Portugal,217,0,1974,1970.4,217,31,1,2,0,0,0,0,0,1,1,1
Myanmar,207,15,1974,1970.4,192,32,3,2,11,4,3,1,0,1,0,0
Ireland,198,7,1974,1970.4,191,33,1,4,3,4,1,1,0,2,0,1
Singapore,182,5,1974,1970.4,177,34,4,4,2,3,0,1,2,2,2,1
China,170,14,1974,1970.4,156,35,3,1,13,1,3,0,0,0,0,1
Uganda,169,5,1974,1970.4,164,36,2,4,0,5,0,0,2,1,0,3
Thailand,166,24,1974,1970.4,142,37,6,7,14,10,4,1,2,4,0,2
Democratic Republic of the Congo,161,16,1974,1970.4,145,38,4,5,4,12,1,4,2,1,1,0
Turkey,160,7,1974,1970.4,153,39,3,3,3,4,1,1,1,1,1,1
Haiti,126,5,1974,1970.4,121,40,8,3,3,2,1,0,5,3,2,0
India,121,7,1974,1970.4,114,41,2,2,4,3,1,0,0,1,1,1
Guinea,120,9,1974,1970.4,111,42,2,5,3,6,1,0,1,2,0,3
Suriname,112,8,1974,1970.4,104,43,3,2,4,4,1,1,1,1,1,0
Tunisia,112,8,1974,1970.4,104,44,3,6,3,5,2,2,1,4,0,0
Hong Kong,110,6,1974,1970.4,104,45,4,1,5,1,1,1,0,0,3,0
Greece,108,11,1974,1970.4,97,46,3,4,7,4,2,0,0,2,1,2
Sudan,108,13,1974,1970.4,95,47,1,4,1,12,0,3,1,1,0,0
Congo,104,12,1974,1970.4,92,48,5,3,9,3,2,1,1,1,2,1
Ivory Coast,102,4,1974,1970.4,98,49,3,3,3,1,0,0,1,3,2,0
Tanzania,96,5,1974,1970.4,91,50,1,3,1,4,0,0,0,1,1,2
Japan,93,5,1974,1970.4,88,51,1,2,4,1,1,1,0,0,0,1
Iraq,91,5,1974,1970.4,86,52,3,2,4,1,1,0,0,2,2,0
Morocco,85,18,1974,1970.4,67,53,4,9,10,8,4,4,0,0,0,5
Libya,84,19,1974,1970.4,65,54,9,2,18,1,5,1,2,1,2,0
Mauritius,81,10,1974,1970.4,71,55,4,2,9,1,2,0,1,2,1,0
Algeria,78,11,1974,1970.4,67,56,5,1,11,0,2,0,2,1,1,0
Panama,74,2,1974,1970.4,72,57,1,1,1,1,1,1,0,0,0,0
Jamaica,71,3,1974,1970.4,68,58,2,1,2,1,1,1,1,0,0,0
Cambodia,69,4,1974,1970.4,65,59,3,3,3,1,0,1,2,2,1,0
Malawi,66,14,1974,1970.4,52,60,5,3,10,4,2,0,1,2,2,1
Mali,66,4,1974,1970.4,62,61,2,1,2,2,1,0,0,0,1,1
Australia,61,3,1974,1970.4,58,62,1,4,0,3,0,1,0,3,1,0
USA,60,1,1974,1970.4,59,63,1,1,0,1,0,0,1,1,0,0
Luxembourg,55,2,1974,1970.4,53,64,1,1,2,0,0,0,1,1,0,0
Iran,48,2,1974,1970.4,46,65,2,1,0,2,0,1,2,0,0,0
Iceland,46,7,1974,1970.4,39,66,2,3,2,5,0,1,1,1,1,1
Togo,37,5,1974,1970.4,32,67,2,2,1,4,1,1,1,1,0,0
Palestine,31,8,1974,1970.4,23,68,2,2,8,0,1,0,1,1,0,1
Bahrain,29,5,1974,1970.4,24,69,4,1,5,0,1,0,3,1,0,0
Dominica,25,3,1974,1970.4,22,70,1,1,0,3,0,1,0,0,1,0
Laos,21,4,1974,1970.4,17,71,4,1,3,1,0,0,2,1,2,0
Cyprus,14,2,1974,1970.4,12,72,1,1,1,1,0,0,1,1,0,0
Saudi Arabia,13,11,1974,1970.4,2,73,2,4,2,9,1,3,0,1,1,0
Somalia,13,6,1974,1970.4,7,74,2,3,1,5,0,1,1,2,1,0
Qatar,12,6,1974,1970.4,6,75,4,2,2,4,0,1,3,1,1,0
Liberia,11,0,1974,1970.4,11,76,1,1,0,0,0,0,1,1,0,0
Malta,5,0,1974,1970.4,5,77,2,1,0,0,0,0,2,0,0,1
Gambia,3,0,1974,1970.4,3,78,1,1,0,0,0,0,1,1,0,0
Burundi,2,2,1974,1970.4,0,79,1,1,0,2,0,1,1,0,0,0
Yemen,2,2,1974,1970.4,0,80,1,3,0,2,0,0,1,3,0,0
Oman,0,0,1974,1970.4,0,81,1,2,0,0,0,0,1,2,0,0
Sweden,1185,12,1975,1970.5,1173,1,4,2,8,4,2,2,0,0,2,0
Germany,1177,31,1975,1970.5,1146,2,6,11,6,25,2,7,1,3,3,1
Hungary,1176,16,1975,1970.5,1160,3,3,5,11,5,2,1,1,2,0,2
England,916,19,1975,1970.5,897,4,4,5,14,5,3,2,0,1,1,2
Argentina,888,29,1975,1970.5,859,5,3,5,17,12,2,3,1,1,0,1
Scotland,780,15,1975,1970.5,765,6,4,6,8,7,3,1,0,1,1,4
Austria,766,9,1975,1970.5,757,7,4,3,6,3,1,1,1,2,2,0
Denmark,705,4,1975,1970.5,701,8,2,4,2,2,1,0,1,3,0,1
Netherlands,667,9,1975,1970.5,658,9,2,4,7,2,2,0,0,3,0,1
Brazil,666,18,1975,1970.5,648,10,4,3,11,7,3,3,1,0,0,0
Belgium,653,3,1975,1970.5,650,11,3,1,3,0,2,0,1,0,0,1
Uruguay,581,8,1975,1970.5,573,12,4,3,4,4,2,2,2,1,0,0
France,572,6,1975,1970.5,566,13,4,2,5,1,2,0,1,1,1,1
Italy,571,19,1975,1970.5,552,14,6,3,18,1,4,1,0,1,2,1
Norway,571,7,1975,1970.5,564,15,1,4,0,7,0,1,1,3,0,0
Czech Republic,552,18,1975,1970.5,534,16,6,3,14,4,3,1,0,0,3,2
Switzerland,522,6,1975,1970.5,516,17,4,3,3,3,1,0,2,2,1,1
Poland,493,33,1975,1970.5,460,18,4,6,15,18,3,4,0,1,1,1
Wales,413,10,1975,1970.5,403,19,2,4,3,7,1,2,0,1,1,1
Paraguay,363,8,1975,1970.5,355,20,3,5,3,5,1,2,2,2,0,1
Spain,363,6,1975,1970.5,357,21,3,1,4,2,1,0,0,0,2,1
Finland,351,4,1975,1970.5,347,22,2,3,3,1,0,0,2,2,0,1
Northern Ireland,343,5,1975,1970.5,338,23,4,1,5,0,2,0,1,1,1,0
Chile,331,8,1975,1970.5,323,24,3,3,6,2,1,0,1,3,1,0
South Korea,330,47,1975,1970.5,283,25,7,13,18,29,6,9,0,4,1,0
Bulgaria,326,8,1975,1970.5,318,26,2,3,6,2,1,1,0,1,1,1
Indonesia,324,23,1975,1970.5,301,27,7,6,15,8,4,2,3,3,0,1
Russia,323,13,1975,1970.5,310,28,4,3,10,3,4,1,0,1,0,1
Mexico,322,13,1975,1970.5,309,29,6,1,13,0,3,0,2,1,1,0
Romania,300,18,1975,1970.5,282,30,5,5,13,5,1,0,0,0,4,5
Malaysia,245,10,1975,1970.5,235,31,7,6,6,4,3,1,2,4,2,1
Myanmar,242,35,1975,1970.5,207,32,11,4,25,10,7,2,4,2,0,0
Costa Rica,240,4,1975,1970.5,236,33,1,2,3,1,1,0,0,1,0,1
Peru,228,18,1975,1970.5,210,34,6,7,12,6,5,3,1,3,0,1
Portugal,225,8,1975,1970.5,217,35,3,5,3,5,1,2,0,3,2,0
Kenya,209,20,1975,1970.5,189,36,5,5,10,10,3,3,0,1,2,1
Ireland,205,7,1975,1970.5,198,37,2,2,6,1,2,0,0,2,0,0
China,203,33,1975,1970.5,170,38,6,6,25,8,4,2,0,3,2,1
Zambia,194,6,1975,1970.5,188,39,3,2,4,2,1,0,2,1,0,1
Singapore,185,3,1975,1970.5,182,40,1,4,2,1,0,1,0,2,1,1
Thailand,179,13,1975,1970.5,166,41,6,11,7,6,4,0,2,8,0,3
Uganda,173,4,1975,1970.5,169,42,2,3,1,3,0,1,2,1,0,1
Turkey,165,5,1975,1970.5,160,43,3,4,2,3,1,0,1,2,1,2
Nigeria,159,9,1975,1970.5,150,44,3,7,3,6,2,3,0,3,1,1
Haiti,134,8,1975,1970.5,126,45,3,4,6,2,2,1,1,2,0,1
Hong Kong,127,17,1975,1970.5,110,46,7,2,8,9,2,1,3,1,2,0
Guinea,125,5,1975,1970.5,120,47,1,2,3,2,1,1,0,1,0,0
Tunisia,121,9,1975,1970.5,112,48,3,3,7,2,2,1,0,0,1,2
Greece,118,10,1975,1970.5,108,49,2,4,5,5,1,1,0,2,1,1
Iraq,118,27,1975,1970.5,91,50,10,2,26,1,8,0,0,1,2,1
Sudan,113,5,1975,1970.5,108,51,1,4,1,4,1,1,0,2,0,1
Bolivia,109,6,1975,1970.5,103,52,5,2,5,1,2,0,3,2,0,0
Congo,108,4,1975,1970.5,104,53,1,3,1,3,1,1,0,2,0,0
Japan,108,15,1975,1970.5,93,54,2,7,5,10,1,3,1,3,0,1
Ecuador,107,11,1975,1970.5,96,55,4,4,10,1,2,0,1,4,1,0
Tanzania,107,11,1975,1970.5,96,56,4,3,7,4,2,0,1,3,1,0
Ivory Coast,106,4,1975,1970.5,102,57,3,4,3,1,1,0,1,3,1,1
Colombia,95,11,1975,1970.5,84,58,5,4,7,4,4,2,1,2,0,0
Libya,88,4,1975,1970.5,84,59,2,2,3,1,1,0,1,2,0,0
Malawi,88,22,1975,1970.5,66,60,10,3,19,3,6,0,1,2,3,1
Cameroon,87,7,1975,1970.5,80,61,3,4,5,2,2,1,0,3,1,0
New Zealand,85,10,1975,1970.5,75,62,3,3,6,4,2,0,0,1,1,2
Panama,85,11,1975,1970.5,74,63,7,1,10,1,2,0,2,1,3,0
Algeria,79,1,1975,1970.5,78,64,1,1,1,0,0,0,1,1,0,0
Kuwait,78,4,1975,1970.5,74,65,1,1,1,3,1,0,0,0,0,1
Jamaica,75,4,1975,1970.5,71,66,2,2,1,3,1,1,1,1,0,0
Guadeloupe,64,8,1975,1970.5,56,67,2,2,6,2,2,0,0,2,0,0
USA,61,1,1975,1970.5,60,68,1,5,0,1,0,0,1,5,0,0
Luxembourg,60,5,1975,1970.5,55,69,2,2,2,3,0,0,2,2,0,0
Iceland,54,8,1975,1970.5,46,70,3,2,8,0,2,0,0,2,1,0
Senegal,46,4,1975,1970.5,42,71,3,2,2,2,2,0,1,1,0,1
Cuba,31,10,1975,1970.5,21,72,1,3,4,6,1,2,0,0,0,1
Canada,30,3,1975,1970.5,27,73,4,1,3,0,0,0,4,1,0,0
Burkina Faso,26,5,1975,1970.5,21,74,1,1,4,1,1,0,0,1,0,0
Saudi Arabia,26,13,1975,1970.5,13,75,4,3,10,3,3,0,1,2,0,1
Barbados,21,1,1975,1970.5,20,76,1,1,1,0,1,0,0,1,0,0
Qatar,17,5,1975,1970.5,12,77,2,4,3,2,1,1,0,3,1,0
Cyprus,15,1,1975,1970.5,14,78,4,3,1,0,0,0,4,3,0,0
Venezuela,13,1,1975,1970.5,12,79,2,2,1,0,0,0,2,2,0,0
Malta,7,2,1975,1970.5,5,80,2,2,2,0,1,0,1,2,0,0
Mozambique,4,4,1975,1970.5,0,81,2,1,4,0,2,0,0,1,0,0
Vanuatu,4,4,1975,1970.5,0,82,1,1,3,1,1,0,0,1,0,0
Germany,1206,29,1976,1970.6,1177,1,6,5,19,10,4,2,0,0,2,3
Sweden,1204,19,1976,1970.6,1185,2,4,6,10,9,2,3,1,2,1,1
Hungary,1192,16,1976,1970.6,1176,3,4,6,6,10,3,3,0,0,1,3
England,937,21,1976,1970.6,916,4,4,7,10,11,3,4,0,3,1,0
Argentina,910,22,1976,1970.6,888,5,6,7,10,12,3,5,1,2,2,0
Scotland,796,16,1976,1970.6,780,6,6,1,16,0,6,0,0,1,0,0
Austria,780,14,1976,1970.6,766,7,4,4,7,7,2,3,2,1,0,0
Denmark,722,17,1976,1970.6,705,8,4,5,9,8,2,3,1,1,1,1
Brazil,690,24,1976,1970.6,666,9,6,5,14,10,6,4,0,0,0,1
Netherlands,678,11,1976,1970.6,667,10,2,3,7,4,1,2,0,1,1,0
Belgium,657,4,1976,1970.6,653,11,2,2,3,1,1,1,1,1,0,0
Italy,593,22,1976,1970.6,571,12,3,6,9,13,3,3,0,3,0,0
Uruguay,590,9,1976,1970.6,581,13,4,7,3,6,0,1,2,3,2,3
France,581,9,1976,1970.6,572,14,3,3,6,3,2,0,0,1,1,2
Norway,575,4,1976,1970.6,571,15,4,3,4,0,2,0,1,3,1,0
Czech Republic,571,19,1976,1970.6,552,16,6,4,14,5,4,0,0,1,2,3
Switzerland,528,6,1976,1970.6,522,17,4,4,5,1,1,0,2,4,1,0
Poland,502,9,1976,1970.6,493,18,3,4,6,3,1,1,2,3,0,0
Wales,416,3,1976,1970.6,413,19,4,2,2,1,1,0,3,2,0,0
South Korea,375,45,1976,1970.6,330,20,8,8,28,17,6,4,0,2,2,2
Paraguay,372,9,1976,1970.6,363,21,3,3,4,5,1,0,1,1,1,2
Finland,364,13,1976,1970.6,351,22,6,3,12,1,4,0,2,3,0,0
Spain,364,1,1976,1970.6,363,23,1,1,1,0,0,0,0,1,1,0
Bulgaria,342,16,1976,1970.6,326,24,5,5,5,11,1,2,2,1,2,2
Russia,334,11,1976,1970.6,323,25,2,8,2,9,0,2,1,3,1,3
Chile,331,0,1976,1970.6,331,26,1,1,0,0,0,0,0,1,1,0
Indonesia,328,4,1976,1970.6,324,27,6,1,3,1,0,0,4,1,2,0
Mexico,325,3,1976,1970.6,322,28,3,2,3,0,1,0,1,1,1,1
Romania,310,10,1976,1970.6,300,29,2,4,4,6,1,0,0,3,1,1
Ghana,288,8,1976,1970.6,280,30,2,2,6,2,2,0,0,2,0,0
Malaysia,274,29,1976,1970.6,245,31,3,11,9,20,3,3,0,4,0,4
Myanmar,261,19,1976,1970.6,242,32,9,3,17,2,4,0,2,1,3,2
Costa Rica,248,8,1976,1970.6,240,33,3,4,4,4,1,0,0,2,2,2
Curaçao,232,1,1976,1970.6,231,34,1,1,1,0,0,0,1,1,0,0
Portugal,231,6,1976,1970.6,225,35,3,2,3,3,2,1,1,1,0,0
Peru,229,1,1976,1970.6,228,36,2,2,1,0,0,0,1,1,1,1
Kenya,224,15,1976,1970.6,209,37,3,5,3,12,0,3,1,1,2,1
Zambia,215,21,1976,1970.6,194,38,2,7,5,16,1,6,1,1,0,0
Ireland,214,9,1976,1970.6,205,39,1,4,3,6,1,1,0,1,0,2
China,207,4,1976,1970.6,203,40,4,1,4,0,2,0,1,1,1,0
Thailand,199,20,1976,1970.6,179,41,4,7,9,11,2,2,0,4,2,1
Uganda,193,20,1976,1970.6,173,42,5,7,11,9,4,3,1,3,0,1
Singapore,188,3,1976,1970.6,185,43,1,5,0,3,0,1,1,4,0,0
Nigeria,180,21,1976,1970.6,159,44,4,7,11,10,3,2,0,2,1,3
Trinidad and Tobago,179,10,1976,1970.6,169,45,2,4,3,7,1,1,0,2,1,1
Turkey,176,11,1976,1970.6,165,46,2,4,7,4,1,0,0,1,1,3
Haiti,153,19,1976,1970.6,134,47,6,4,11,8,2,3,0,0,4,1
Guinea,148,23,1976,1970.6,125,48,7,6,12,11,3,3,1,1,3,2
Iraq,148,30,1976,1970.6,118,49,10,5,26,4,5,1,2,2,3,2
Egypt,139,14,1976,1970.6,125,50,6,2,11,3,2,1,3,0,1,1
Guatemala,139,17,1976,1970.6,122,51,5,3,13,4,4,1,0,1,1,1
Ethiopia,131,9,1976,1970.6,122,52,5,2,8,1,2,0,2,2,1,0
Israel,131,4,1976,1970.6,127,53,4,1,3,1,0,1,2,0,2,0
India,129,8,1976,1970.6,121,54,6,3,5,3,0,0,5,1,1,2
Hong Kong,128,1,1976,1970.6,127,55,1,2,0,1,0,1,1,1,0,0
Tunisia,128,7,1976,1970.6,121,56,2,3,4,3,1,1,0,0,1,2
Japan,126,18,1976,1970.6,108,57,6,3,5,13,0,2,3,0,3,1
Congo,122,14,1976,1970.6,108,58,3,3,8,6,2,2,0,0,1,1
El Salvador,122,11,1976,1970.6,111,59,4,4,8,3,2,0,1,2,1,2
Suriname,121,9,1976,1970.6,112,60,3,2,7,2,2,0,0,1,1,1
Ivory Coast,120,14,1976,1970.6,106,61,4,2,10,4,3,1,1,0,0,1
Sudan,116,3,1976,1970.6,113,62,1,3,1,2,0,0,0,2,1,1
Malawi,114,26,1976,1970.6,88,63,10,3,23,3,5,0,3,1,2,2
Martinique,113,4,1976,1970.6,109,64,1,1,3,1,1,1,0,0,0,0
Tanzania,111,4,1976,1970.6,107,65,3,1,4,0,0,0,1,0,2,1
Kuwait,110,32,1976,1970.6,78,66,4,7,13,19,3,5,0,1,1,1
Morocco,101,16,1976,1970.6,85,67,5,4,9,7,3,3,0,0,2,1
Libya,93,5,1976,1970.6,88,68,4,6,2,3,2,0,1,5,1,1
Cameroon,92,5,1976,1970.6,87,69,2,1,3,2,1,0,1,0,0,1
New Zealand,92,7,1976,1970.6,85,70,2,4,3,4,1,1,1,3,0,0
Panama,92,7,1976,1970.6,85,71,4,3,6,1,1,0,2,3,1,0
Algeria,87,8,1976,1970.6,79,72,4,6,4,4,2,2,2,3,0,1
Mauritius,87,6,1976,1970.6,81,73,1,3,3,3,0,1,1,1,0,1
Jamaica,76,1,1976,1970.6,75,74,1,1,1,0,0,0,1,1,0,0
Mali,73,7,1976,1970.6,66,75,1,3,2,5,1,2,0,0,0,1
Australia,72,11,1976,1970.6,61,76,3,5,5,6,2,3,1,0,0,2
Guadeloupe,66,2,1976,1970.6,64,77,1,1,0,2,0,0,1,1,0,0
USA,65,4,1976,1970.6,61,78,5,6,3,1,1,0,3,2,1,4
Iceland,64,10,1976,1970.6,54,79,3,3,3,7,1,2,2,1,0,0
Luxembourg,63,3,1976,1970.6,60,80,1,2,1,2,0,0,1,2,0,0
Senegal,54,8,1976,1970.6,46,81,1,4,1,7,0,1,0,2,1,1
Cuba,44,13,1976,1970.6,31,82,3,4,3,10,1,2,1,1,1,1
Togo,39,2,1976,1970.6,37,83,1,2,1,1,1,0,0,1,0,1
Bahrain,38,9,1976,1970.6,29,84,5,1,9,0,3,0,2,1,0,0
Saudi Arabia,38,12,1976,1970.6,26,85,7,6,5,7,2,1,4,5,1,0
Syria,37,2,1976,1970.6,35,86,1,1,2,0,1,0,0,1,0,0
Canada,35,5,1976,1970.6,30,87,3,2,5,0,2,0,0,1,1,1
Sierra Leone,34,12,1976,1970.6,22,88,4,3,7,5,2,0,0,3,2,0
Burkina Faso,31,5,1976,1970.6,26,89,2,3,2,3,0,1,0,2,2,0
Barbados,24,3,1976,1970.6,21,90,2,1,3,0,1,0,1,1,0,0
Guyana,22,2,1976,1970.6,20,91,1,1,2,0,1,0,0,1,0,0
Pakistan,22,2,1976,1970.6,20,92,1,2,1,1,1,0,0,1,0,1
Gabon,20,10,1976,1970.6,10,93,4,2,7,3,1,1,2,1,1,0
Cyprus,17,2,1976,1970.6,15,94,2,2,2,0,0,0,2,2,0,0
Niger,14,3,1976,1970.6,11,95,1,1,2,1,1,0,0,1,0,0
Guinea-Bissau,13,2,1976,1970.6,11,96,1,1,1,1,0,0,0,1,1,0
Malta,10,3,1976,1970.6,7,97,3,2,3,0,0,0,1,2,2,0
Chad,5,5,1976,1970.6,0,98,1,1,4,1,1,1,0,0,0,0
Réunion,5,5,1976,1970.6,0,99,2,1,1,4,0,1,2,0,0,0
Angola,3,3,1976,1970.6,0,100,1,1,1,2,0,0,0,1,1,0
Botswana,3,3,1976,1970.6,0,101,1,2,2,1,0,0,1,2,0,0
Oman,3,3,1976,1970.6,0,102,2,4,2,1,0,0,1,4,1,0
São Tomé and Príncipe,3,3,1976,1970.6,0,103,1,1,2,1,0,0,1,1,0,0
Afghanistan,2,2,1976,1970.6,0,104,2,1,2,0,1,0,0,1,1,0
Burundi,2,0,1976,1970.6,2,105,1,2,0,0,0,0,1,2,0,0
Mauritania,2,2,1976,1970.6,0,106,2,2,1,1,0,0,2,1,0,1
Dominican Republic,0,0,1976,1970.6,0,107,1,1,0,0,0,0,1,1,0,0
Germany,1246,40,1977,1970.7,1206,1,8,12,25,15,6,6,0,2,2,4
Hungary,1221,29,1977,1970.7,1192,2,6,8,18,11,6,2,0,3,0,3
Sweden,1213,9,1977,1970.7,1204,3,4,6,4,5,3,1,1,5,0,0
England,950,13,1977,1970.7,937,4,6,5,8,5,2,2,3,0,1,3
Argentina,926,16,1977,1970.7,910,5,9,1,16,0,4,0,1,1,4,0
Scotland,814,18,1977,1970.7,796,6,3,7,9,9,3,3,0,2,0,2
Austria,797,17,1977,1970.7,780,7,5,3,15,2,4,1,0,0,1,2
Denmark,740,18,1977,1970.7,722,8,3,7,5,13,1,4,2,3,0,0
Brazil,716,26,1977,1970.7,690,9,9,3,24,2,5,2,0,0,4,1
Netherlands,688,10,1977,1970.7,678,10,3,3,5,5,2,3,0,0,1,0
Belgium,662,5,1977,1970.7,657,11,3,3,4,1,1,0,2,3,0,0
Italy,609,16,1977,1970.7,593,12,3,4,11,5,3,2,0,2,0,0
Uruguay,602,12,1977,1970.7,590,13,7,3,10,2,3,0,1,1,3,2
France,593,12,1977,1970.7,581,14,4,4,6,6,3,1,0,1,1,2
Czech Republic,580,9,1977,1970.7,571,15,6,4,8,1,3,0,1,4,2,0
Norway,579,4,1977,1970.7,575,16,3,3,3,1,1,0,1,3,1,0
Switzerland,535,7,1977,1970.7,528,17,5,4,5,2,3,0,2,3,0,1
Poland,524,22,1977,1970.7,502,18,3,10,7,15,2,4,0,5,1,1
South Korea,429,54,1977,1970.7,375,19,12,13,31,23,10,5,0,1,2,7
Wales,422,6,1977,1970.7,416,20,4,5,3,3,1,1,1,1,2,3
Paraguay,392,20,1977,1970.7,372,21,6,9,8,12,3,3,1,4,2,2
Finland,370,6,1977,1970.7,364,22,3,5,1,5,0,2,3,2,0,1
Spain,370,6,1977,1970.7,364,23,2,3,3,3,1,2,0,1,1,0
Bulgaria,354,12,1977,1970.7,342,24,4,6,8,4,3,1,0,3,1,2
Northern Ireland,350,7,1977,1970.7,343,25,5,3,7,0,2,0,2,3,1,0
Russia,347,13,1977,1970.7,334,26,3,6,8,5,3,1,0,3,0,2
Chile,342,11,1977,1970.7,331,27,4,4,10,1,2,1,1,3,1,0
Indonesia,335,7,1977,1970.7,328,28,1,3,0,7,0,1,0,2,1,0
Romania,325,15,1977,1970.7,310,29,4,4,12,3,3,1,0,2,1,1
Ghana,297,9,1977,1970.7,288,30,2,3,6,3,2,1,0,2,0,0
Malaysia,296,22,1977,1970.7,274,31,6,6,14,8,3,3,0,2,3,1
Myanmar,265,4,1977,1970.7,261,32,4,1,4,0,1,0,2,1,1,0
Peru,252,23,1977,1970.7,229,33,6,6,15,8,4,1,2,1,0,4
Zambia,243,28,1977,1970.7,215,34,7,6,20,8,5,2,1,3,1,1
Portugal,241,10,1977,1970.7,231,35,2,2,5,5,2,1,0,0,0,1
China,229,22,1977,1970.7,207,36,5,6,14,8,4,3,1,2,0,1
Kenya,229,5,1977,1970.7,224,37,5,1,5,0,0,0,3,1,2,0
Thailand,226,27,1977,1970.7,199,38,6,10,11,16,2,1,2,6,2,3
Ireland,216,2,1977,1970.7,214,39,4,1,1,1,1,0,1,1,2,0
Uganda,201,8,1977,1970.7,193,40,3,3,2,6,1,2,0,1,2,0
Nigeria,200,20,1977,1970.7,180,41,5,3,17,3,4,0,1,1,0,2
Singapore,197,9,1977,1970.7,188,42,7,3,5,4,2,0,4,3,1,0
Trinidad and Tobago,186,7,1977,1970.7,179,43,1,4,1,6,0,1,0,2,1,1
Turkey,185,9,1977,1970.7,176,44,4,6,4,5,1,2,3,4,0,0
Haiti,162,9,1977,1970.7,153,45,3,4,4,5,1,2,1,1,1,1
Iraq,161,13,1977,1970.7,148,46,5,3,9,4,2,1,1,0,2,2
Guinea,156,8,1977,1970.7,148,47,3,3,5,3,3,1,0,2,0,0
Guatemala,152,13,1977,1970.7,139,48,4,3,9,4,3,0,1,2,0,1
Egypt,149,10,1977,1970.7,139,49,4,4,9,1,4,0,0,2,0,2
Hong Kong,149,21,1977,1970.7,128,50,7,10,10,11,3,3,4,5,0,2
Tunisia,144,16,1977,1970.7,128,51,8,5,12,4,4,1,2,3,2,1
Israel,142,11,1977,1970.7,131,52,4,4,5,6,2,0,0,1,2,3
Malawi,138,24,1977,1970.7,114,53,7,6,11,13,4,3,1,2,2,1
India,137,8,1977,1970.7,129,54,3,5,2,6,1,1,2,3,0,1
Ivory Coast,135,15,1977,1970.7,120,55,4,4,11,4,3,2,0,2,1,0
Kuwait,133,23,1977,1970.7,110,56,5,9,8,15,2,6,1,2,2,1
El Salvador,131,9,1977,1970.7,122,57,4,3,6,3,1,1,2,1,1,1
Congo,129,7,1977,1970.7,122,58,2,2,3,4,0,0,1,1,1,1
Suriname,129,8,1977,1970.7,121,59,1,5,2,6,1,0,0,5,0,0
Japan,127,1,1977,1970.7,126,60,1,4,0,1,0,0,0,4,1,0
Bolivia,122,13,1977,1970.7,109,61,6,5,8,5,2,1,3,3,1,1
Greece,121,3,1977,1970.7,118,62,1,7,1,2,1,0,0,5,0,2
Martinique,119,6,1977,1970.7,113,63,1,2,1,5,1,2,0,0,0,0
Ecuador,116,9,1977,1970.7,107,64,4,6,7,2,2,1,1,4,1,1
Morocco,115,14,1977,1970.7,101,65,2,7,5,9,1,2,0,3,1,2
Tanzania,115,4,1977,1970.7,111,66,2,3,4,0,1,0,1,1,0,2
New Zealand,107,15,1977,1970.7,92,67,4,1,14,1,3,0,0,1,1,0
Libya,99,6,1977,1970.7,93,68,4,3,5,1,3,0,0,2,1,1
Colombia,97,2,1977,1970.7,95,69,3,3,0,2,0,0,2,2,1,1
Australia,94,22,1977,1970.7,72,70,8,7,14,8,4,2,2,3,2,2
Mauritius,94,7,1977,1970.7,87,71,2,1,5,2,2,1,0,0,0,0
Panama,92,0,1977,1970.7,92,72,1,1,0,0,0,0,1,1,0,0
Algeria,91,4,1977,1970.7,87,73,3,1,4,0,1,0,0,1,2,0
Mali,77,4,1977,1970.7,73,74,1,2,1,3,1,1,0,1,0,0
USA,72,7,1977,1970.7,65,75,4,4,4,3,2,1,0,3,2,0
Iceland,68,4,1977,1970.7,64,76,3,3,3,1,2,0,1,3,0,0
Iran,68,20,1977,1970.7,48,77,9,7,11,9,4,4,2,1,3,2
Guadeloupe,67,1,1977,1970.7,66,78,1,1,1,0,0,0,1,1,0,0
Luxembourg,63,0,1977,1970.7,63,79,2,2,0,0,0,0,2,2,0,0
Senegal,62,8,1977,1970.7,54,80,3,2,6,2,2,1,1,1,0,0
Bahrain,45,7,1977,1970.7,38,81,5,2,4,3,0,1,4,1,1,0
Canada,43,8,1977,1970.7,35,82,4,2,6,2,2,0,1,1,1,1
Togo,40,1,1977,1970.7,39,83,2,2,0,1,0,0,2,2,0,0
Saudi Arabia,38,0,1977,1970.7,38,84,1,1,0,0,0,0,1,1,0,0
Burkina Faso,32,1,1977,1970.7,31,85,1,1,0,1,0,0,1,1,0,0
Gabon,23,3,1977,1970.7,20,86,1,2,0,3,0,0,1,1,0,1
Cyprus,19,2,1977,1970.7,17,87,2,2,2,0,0,0,2,2,0,0
Venezuela,16,3,1977,1970.7,13,88,3,2,3,0,1,0,1,2,1,0
Zimbabwe,14,1,1977,1970.7,13,89,1,1,1,0,0,0,0,1,1,0
Malta,12,2,1977,1970.7,10,90,2,5,0,2,0,1,2,4,0,0
South Africa,8,8,1977,1970.7,0,91,1,1,7,1,1,0,0,0,0,1
Mozambique,5,1,1977,1970.7,4,92,1,1,0,1,0,0,1,1,0,0
Germany,1277,31,1978,1970.8,1246,1,16,4,24,7,7,1,2,3,7,0
Hungary,1231,10,1978,1970.8,1221,2,3,6,5,5,2,0,1,5,0,1
Sweden,1224,11,1978,1970.8,1213,3,4,6,6,5,2,1,1,3,1,2
England,967,17,1978,1970.8,950,4,4,5,7,10,3,3,0,1,1,1
Argentina,954,28,1978,1970.8,926,5,11,2,25,3,9,1,1,1,1,0
Scotland,828,14,1978,1970.8,814,6,5,5,7,7,2,1,1,3,2,1
Austria,812,15,1978,1970.8,797,7,9,4,11,4,4,2,5,1,0,1
Denmark,753,13,1978,1970.8,740,8,4,4,10,3,1,1,1,2,2,1
Brazil,733,17,1978,1970.8,716,9,7,5,14,3,5,2,0,1,2,2
Netherlands,720,32,1978,1970.8,688,10,4,10,8,24,2,7,1,2,1,1
Belgium,665,3,1978,1970.8,662,11,2,3,2,1,1,0,0,1,1,2
Italy,624,15,1978,1970.8,609,12,5,8,6,9,3,4,1,3,1,1
France,613,20,1978,1970.8,593,13,8,3,14,6,6,1,1,1,1,1
Uruguay,604,2,1978,1970.8,602,14,2,1,2,0,1,0,0,1,1,0
Czech Republic,592,12,1978,1970.8,580,15,3,7,6,6,1,2,1,4,1,1
Norway,584,5,1978,1970.8,579,16,3,4,1,4,0,0,2,2,1,2
Poland,547,23,1978,1970.8,524,17,5,9,12,11,5,5,0,3,0,1
Switzerland,539,4,1978,1970.8,535,18,3,2,3,1,1,0,2,2,0,0
South Korea,467,38,1978,1970.8,429,19,7,7,17,21,6,7,0,0,1,0
Wales,434,12,1978,1970.8,422,20,4,2,10,2,3,1,1,0,0,1
Spain,385,15,1978,1970.8,370,21,6,5,14,1,6,0,0,3,0,2
Finland,380,10,1978,1970.8,370,22,5,3,6,4,2,0,2,3,1,0
Russia,377,30,1978,1970.8,347,23,2,9,12,18,2,7,0,2,0,0
Bulgaria,363,9,1978,1970.8,354,24,2,10,1,8,0,0,1,5,1,5
Northern Ireland,355,5,1978,1970.8,350,25,1,5,2,3,1,1,0,2,0,2
Mexico,340,15,1978,1970.8,325,26,3,5,2,13,0,3,3,2,0,0
Romania,332,7,1978,1970.8,325,27,3,6,3,4,2,0,1,3,0,3
Ghana,316,19,1978,1970.8,297,28,7,1,19,0,6,0,0,1,1,0
Malaysia,306,10,1978,1970.8,296,29,5,3,6,4,0,1,2,1,3,1
Zambia,292,49,1978,1970.8,243,30,3,12,11,38,1,8,1,3,1,1
Peru,265,13,1978,1970.8,252,31,5,7,7,6,2,2,2,4,1,1
Portugal,246,5,1978,1970.8,241,32,3,2,3,2,2,1,0,1,1,0
Thailand,245,19,1978,1970.8,226,33,1,12,2,17,0,5,0,5,1,2
China,237,8,1978,1970.8,229,34,2,4,3,5,2,2,0,2,0,0
Kenya,234,5,1978,1970.8,229,35,6,5,4,1,3,1,2,4,1,0
Curaçao,233,1,1978,1970.8,232,36,2,2,1,0,1,0,1,1,0,1
Ireland,224,8,1978,1970.8,216,37,3,3,5,3,1,0,0,1,2,2
Uganda,216,15,1978,1970.8,201,38,2,9,1,14,0,5,2,3,0,1
Singapore,211,14,1978,1970.8,197,39,4,8,6,8,1,2,3,2,0,4
Nigeria,209,9,1978,1970.8,200,40,4,2,7,2,2,1,1,0,1,1
Trinidad and Tobago,200,14,1978,1970.8,186,41,5,1,13,1,3,0,1,0,1,1
Turkey,188,3,1978,1970.8,185,42,2,3,1,2,0,0,1,3,1,0
Iraq,176,15,1978,1970.8,161,43,8,3,10,5,5,1,2,0,1,2
Malawi,168,30,1978,1970.8,138,44,12,2,29,1,9,0,2,1,1,1
Haiti,167,5,1978,1970.8,162,45,3,4,1,4,1,1,1,0,1,3
Tunisia,152,8,1978,1970.8,144,46,2,9,3,5,1,1,1,5,0,3
Suriname,146,17,1978,1970.8,129,47,2,5,5,12,2,5,0,0,0,0
Greece,143,22,1978,1970.8,121,48,5,6,15,7,3,3,1,3,1,0
Japan,141,14,1978,1970.8,127,49,8,2,13,1,3,0,5,1,0,1
Congo,131,2,1978,1970.8,129,50,3,3,1,1,0,0,2,3,1,0
Martinique,131,12,1978,1970.8,119,51,4,3,9,3,2,1,1,1,1,1
Morocco,120,5,1978,1970.8,115,52,3,2,3,2,0,2,2,0,1,0
Tanzania,116,1,1978,1970.8,115,53,1,1,1,0,1,0,0,0,0,1
Mauritius,103,9,1978,1970.8,94,54,2,3,2,7,1,2,1,1,0,0
Algeria,101,10,1978,1970.8,91,55,3,7,4,6,1,2,0,4,2,1
Jamaica,77,1,1978,1970.8,76,56,1,1,1,0,0,0,1,1,0,0
Iran,75,7,1978,1970.8,68,57,7,1,6,1,1,0,4,1,2,0
Guadeloupe,72,5,1978,1970.8,67,58,1,2,1,4,1,2,0,0,0,0
Iceland,69,1,1978,1970.8,68,59,3,2,0,1,0,0,1,2,2,0
Madagascar,50,3,1978,1970.8,47,60,1,1,2,1,1,0,0,1,0,0
Bahrain,47,2,1978,1970.8,45,61,1,1,1,1,0,0,1,1,0,0
Burkina Faso,44,12,1978,1970.8,32,62,3,4,6,6,2,1,1,2,0,1
Syria,44,7,1978,1970.8,37,63,3,5,3,4,1,0,2,5,0,0
Barbados,28,4,1978,1970.8,24,64,3,3,4,0,2,0,0,2,1,1
Guyana,24,2,1978,1970.8,22,65,1,5,0,2,0,0,1,5,0,0
Benin,22,0,1978,1970.8,22,66,1,1,0,0,0,0,1,1,0,0
Cyprus,19,0,1978,1970.8,19,67,1,1,0,0,0,0,1,1,0,0
Somalia,16,3,1978,1970.8,13,68,2,2,2,1,0,0,1,2,1,0
Réunion,14,9,1978,1970.8,5,69,3,1,9,0,2,0,1,1,0,0
Puerto Rico,7,6,1978,1970.8,1,70,2,2,5,1,1,0,0,2,1,0
Lesotho,5,2,1978,1970.8,3,71,2,2,1,1,0,1,2,1,0,0
Swaziland,5,5,1978,1970.8,0,72,2,1,3,2,0,0,2,1,0,0
Antigua and Barbuda,4,1,1978,1970.8,3,73,3,2,0,1,0,0,3,2,0,0
Macau,2,2,1978,1970.8,0,74,1,2,0,2,0,0,1,2,0,0
Seychelles,2,2,1978,1970.8,0,75,1,2,1,1,1,0,0,2,0,0
Germany,1315,38,1979,1970.9,1277,1,7,14,19,19,6,6,1,4,0,4
Hungary,1243,12,1979,1970.9,1231,2,5,3,8,4,3,0,1,1,1,2
Sweden,1242,18,1979,1970.9,1224,3,4,8,6,12,2,2,1,4,1,2
England,990,23,1979,1970.9,967,4,5,5,10,13,4,3,0,1,1,1
Argentina,969,15,1979,1970.9,954,5,4,6,7,8,2,1,0,3,2,2
Scotland,838,10,1979,1970.9,828,6,5,4,5,5,1,1,2,3,2,0
Austria,828,16,1979,1970.9,812,7,4,4,11,5,3,2,0,0,1,2
Denmark,764,11,1979,1970.9,753,8,4,5,8,3,2,1,1,3,1,1
Brazil,754,21,1979,1970.9,733,9,5,3,17,4,4,0,0,2,1,1
Netherlands,732,12,1979,1970.9,720,10,3,5,5,7,2,2,0,2,1,1
Belgium,675,10,1979,1970.9,665,11,3,4,5,5,2,2,0,1,1,1
France,630,17,1979,1970.9,613,12,3,3,8,9,3,2,0,1,0,0
Czech Republic,612,20,1979,1970.9,592,13,5,4,15,5,5,1,0,3,0,0
Uruguay,612,8,1979,1970.9,604,14,3,5,6,2,2,0,0,4,1,1
Norway,588,4,1979,1970.9,584,15,4,3,3,1,1,0,3,3,0,0
Poland,567,20,1979,1970.9,547,16,6,5,14,6,4,2,0,2,2,1
Switzerland,545,6,1979,1970.9,539,17,3,4,2,4,1,1,2,3,0,0
South Korea,500,33,1979,1970.9,467,18,5,1,32,1,5,0,0,1,0,0
Wales,443,9,1979,1970.9,434,19,3,5,5,4,2,1,1,2,0,2
Paraguay,412,20,1979,1970.9,392,20,5,9,9,11,4,2,0,3,1,4
Russia,404,27,1979,1970.9,377,21,11,4,21,6,7,2,1,1,3,1
Spain,392,7,1979,1970.9,385,22,2,3,2,5,0,1,1,1,1,1
Finland,387,7,1979,1970.9,380,23,2,7,1,6,0,2,0,4,2,1
Bulgaria,371,8,1979,1970.9,363,24,4,6,5,3,3,1,1,5,0,0
Northern Ireland,360,5,1979,1970.9,355,25,5,3,5,0,2,0,2,3,1,0
Chile,358,16,1979,1970.9,342,26,7,6,11,5,4,1,0,4,3,1
Mexico,344,4,1979,1970.9,340,27,2,1,2,2,1,1,0,0,1,0
Romania,341,9,1979,1970.9,332,28,3,4,7,2,2,0,0,3,1,1
Indonesia,337,2,1979,1970.9,335,29,5,3,2,0,1,0,1,3,3,0
Ghana,317,1,1979,1970.9,316,30,1,1,0,1,0,0,0,1,1,0
Zambia,307,15,1979,1970.9,292,31,2,5,6,9,2,3,0,1,0,1
Myanmar,276,11,1979,1970.9,265,32,4,1,10,1,3,0,1,1,0,0
Peru,276,11,1979,1970.9,265,33,5,5,7,4,2,1,3,2,0,2
Thailand,257,12,1979,1970.9,245,34,2,5,8,4,2,1,0,3,0,1
Portugal,252,6,1979,1970.9,246,35,2,3,4,2,1,1,1,1,0,1
Kenya,244,10,1979,1970.9,234,36,5,3,10,0,2,0,1,2,2,1
Ireland,235,11,1979,1970.9,224,37,5,4,9,2,3,0,1,4,1,0
Uganda,221,5,1979,1970.9,216,38,1,2,1,4,0,0,1,2,0,0
Nigeria,219,10,1979,1970.9,209,39,1,4,5,5,1,1,0,0,0,3
Singapore,214,3,1979,1970.9,211,40,2,3,1,2,0,0,1,2,1,1
Trinidad and Tobago,206,6,1979,1970.9,200,41,1,6,2,4,1,1,0,3,0,2
Turkey,193,5,1979,1970.9,188,42,4,2,3,2,2,1,1,1,1,0
Malawi,190,22,1979,1970.9,168,43,11,3,16,6,6,2,3,1,2,0
Democratic Republic of the Congo,183,22,1979,1970.9,161,44,4,6,12,10,3,2,1,3,0,1
Haiti,179,12,1979,1970.9,167,45,3,3,5,7,3,3,0,0,0,0
Guinea,171,15,1979,1970.9,156,46,5,4,9,6,2,0,2,2,1,2
Japan,154,13,1979,1970.9,141,47,4,3,11,2,4,1,0,1,0,1
Ivory Coast,151,16,1979,1970.9,135,48,6,4,14,2,4,0,2,4,0,0
Greece,147,4,1979,1970.9,143,49,1,4,1,3,1,0,0,2,0,2
Congo,140,9,1979,1970.9,131,50,1,3,4,5,1,2,0,1,0,0
Kuwait,138,5,1979,1970.9,133,51,1,1,3,2,1,1,0,0,0,0
Martinique,137,6,1979,1970.9,131,52,2,2,3,3,1,2,0,0,1,0
El Salvador,132,1,1979,1970.9,131,53,1,1,0,1,0,0,1,0,0,1
Bolivia,130,8,1979,1970.9,122,54,4,3,8,0,3,0,0,3,1,0
Tanzania,129,13,1979,1970.9,116,55,2,8,7,6,1,2,0,4,1,2
Ecuador,125,9,1979,1970.9,116,56,4,4,7,2,3,0,1,3,0,1
Sudan,123,7,1979,1970.9,116,57,1,5,2,5,1,2,0,3,0,0
New Zealand,121,14,1979,1970.9,107,58,1,4,1,13,1,4,0,0,0,0
Colombia,104,7,1979,1970.9,97,59,3,3,6,1,2,1,1,1,0,1
Libya,102,3,1979,1970.9,99,60,3,1,3,0,1,0,0,1,2,0
Cameroon,97,5,1979,1970.9,92,61,2,1,4,1,1,1,1,0,0,0
Lithuania,89,4,1979,1970.9,85,62,1,6,0,4,0,2,1,3,0,1
Mali,87,10,1979,1970.9,77,63,3,4,6,4,2,2,1,1,0,1
Jamaica,81,4,1979,1970.9,77,64,2,2,2,2,1,1,1,1,0,0
USA,79,7,1979,1970.9,72,65,1,4,0,7,0,2,1,2,0,0
New Caledonia,76,22,1979,1970.9,54,66,2,1,12,10,1,1,1,0,0,0
Senegal,75,13,1979,1970.9,62,67,3,9,2,11,1,4,2,3,0,2
Iceland,71,2,1979,1970.9,69,68,4,2,2,0,0,0,4,2,0,0
Luxembourg,64,1,1979,1970.9,63,69,2,3,1,0,0,0,1,3,1,0
Togo,54,14,1979,1970.9,40,70,1,8,5,9,1,4,0,2,0,2
Bahrain,50,3,1979,1970.9,47,71,5,2,2,1,0,0,4,2,1,0
Saudi Arabia,40,2,1979,1970.9,38,72,1,1,2,0,1,0,0,1,0,0
Benin,29,7,1979,1970.9,22,73,7,3,5,2,2,0,4,3,1,0
Gabon,28,5,1979,1970.9,23,74,1,3,2,3,1,0,0,2,0,1
Grenada,27,1,1979,1970.9,26,75,1,1,0,1,0,0,1,1,0,0
Sri Lanka,24,1,1979,1970.9,23,76,1,3,0,1,0,0,1,2,0,1
Cyprus,21,2,1979,1970.9,19,77,3,1,2,0,0,0,2,1,1,0
Liberia,20,9,1979,1970.9,11,78,5,1,9,0,3,0,0,0,2,1
Niger,17,3,1979,1970.9,14,79,1,1,2,1,0,1,0,0,1,0
Papua New Guinea,17,15,1979,1970.9,2,80,1,2,2,13,0,1,1,1,0,0
Vanuatu,17,13,1979,1970.9,4,81,2,1,9,4,2,1,0,0,0,0
Venezuela,17,1,1979,1970.9,16,82,2,2,1,0,0,0,0,2,2,0
Malta,14,2,1979,1970.9,12,83,3,2,1,1,0,0,2,2,1,0
Belarus,11,7,1979,1970.9,4,84,6,1,7,0,2,0,3,0,1,1
Gambia,11,8,1979,1970.9,3,85,5,2,8,0,2,0,1,2,2,0
Bangladesh,10,5,1979,1970.9,5,86,3,1,5,0,1,0,2,1,0,0
Lesotho,7,2,1979,1970.9,5,87,1,2,0,2,0,1,1,1,0,0
Angola,6,3,1979,1970.9,3,88,3,1,1,2,1,1,2,0,0,0
Antigua and Barbuda,5,1,1979,1970.9,4,89,1,1,1,0,0,0,1,1,0,0
United Arab Emirates,5,5,1979,1970.9,0,90,1,2,0,5,0,1,0,1,1,0
Tonga,4,4,1979,1970.9,0,91,1,1,3,1,0,0,1,1,0,0
Kiribati,3,3,1979,1970.9,0,92,2,1,3,0,0,0,1,1,1,0
Oman,3,0,1979,1970.9,3,93,2,1,0,0,0,0,2,1,0,0
St. Kitts and Nevis,2,2,1979,1970.9,0,94,1,1,1,1,0,0,1,1,0,0
Cape Verde,0,0,1979,1970.9,0,95,1,1,0,0,0,0,1,1,0,0
Germany,1352,37,1980,1980,1315,1,8,9,23,14,7,6,0,0,1,3
Hungary,1255,12,1980,1980,1243,2,6,3,11,1,3,0,1,3,2,0
Sweden,1250,8,1980,1980,1242,3,5,5,3,5,0,2,3,2,2,1
England,1013,23,1980,1980,990,4,5,8,12,11,4,4,0,3,1,1
Argentina,989,20,1980,1980,969,5,6,3,13,7,4,2,0,1,2,0
Scotland,845,7,1980,1980,838,6,4,4,5,2,2,1,1,3,1,0
Austria,841,13,1980,1980,828,7,3,4,9,4,2,2,1,1,0,1
Denmark,775,11,1980,1980,764,8,4,4,9,2,2,1,1,2,1,1
Brazil,771,17,1980,1980,754,9,7,1,15,2,5,1,1,0,1,0
Netherlands,738,6,1980,1980,732,10,3,6,3,3,1,0,0,5,2,1
Belgium,694,19,1980,1980,675,11,8,3,16,3,6,1,1,0,1,2
France,645,15,1980,1980,630,12,3,3,7,8,2,1,0,2,1,0
Italy,640,16,1980,1980,624,13,9,2,12,4,5,2,0,0,4,0
Czech Republic,634,22,1980,1980,612,14,4,12,3,19,2,3,2,4,0,5
Uruguay,634,22,1980,1980,612,15,6,6,17,5,4,2,0,3,2,1
Norway,602,14,1980,1980,588,16,4,3,11,3,3,1,0,2,1,0
Poland,594,27,1980,1980,567,17,4,13,10,17,3,4,0,6,1,3
Switzerland,554,9,1980,1980,545,18,5,5,8,1,2,0,2,5,1,0
South Korea,537,37,1980,1980,500,19,8,8,25,12,7,5,1,1,0,2
Wales,456,13,1980,1980,443,20,4,2,9,4,3,1,1,1,0,0
Russia,429,25,1980,1980,404,21,3,6,8,17,3,5,0,0,0,1
Paraguay,419,7,1980,1980,412,22,2,3,3,4,1,1,1,1,0,1
Spain,402,10,1980,1980,392,23,6,5,5,5,1,0,4,1,1,4
Finland,391,4,1980,1980,387,24,3,6,0,4,0,0,3,4,0,2
Bulgaria,381,10,1980,1980,371,25,5,5,7,3,1,1,4,2,0,2
Mexico,369,25,1980,1980,344,26,5,9,13,12,2,3,1,3,2,3
Northern Ireland,369,9,1980,1980,360,27,2,6,4,5,2,2,0,1,0,3
Romania,352,11,1980,1980,341,28,3,4,6,5,2,1,0,2,1,1
Indonesia,345,8,1980,1980,337,29,6,6,5,3,1,1,1,5,4,0
Zambia,331,24,1980,1980,307,30,8,10,16,8,4,2,1,5,3,3
Malaysia,328,22,1980,1980,306,31,9,5,17,5,4,1,2,2,3,2
Ghana,326,9,1980,1980,317,32,3,2,5,4,2,1,1,0,0,1
Myanmar,285,9,1980,1980,276,33,5,1,7,2,2,0,1,1,2,0
Peru,277,1,1980,1980,276,34,1,1,1,0,0,0,0,0,1,1
Thailand,270,13,1980,1980,257,35,1,9,0,13,0,3,1,3,0,3
Costa Rica,261,13,1980,1980,248,36,7,5,10,3,3,0,2,0,2,5
China,259,22,1980,1980,237,37,6,4,20,2,5,1,0,2,1,1
Portugal,259,7,1980,1980,252,38,3,3,5,2,2,0,0,2,1,1
Kenya,252,8,1980,1980,244,39,5,2,8,0,3,0,1,2,1,0
Ireland,249,14,1980,1980,235,40,5,3,11,3,3,1,1,2,1,0
Curaçao,234,1,1980,1980,233,41,2,2,1,0,0,0,0,1,2,1
Nigeria,234,15,1980,1980,219,42,9,3,12,3,6,2,0,1,3,0
Singapore,218,4,1980,1980,214,43,2,2,0,4,0,1,2,0,0,1
Trinidad and Tobago,212,6,1980,1980,206,44,5,2,6,0,2,0,0,1,3,1
Turkey,203,10,1980,1980,193,45,4,2,10,0,2,0,2,2,0,0
Democratic Republic of the Congo,197,14,1980,1980,183,46,4,3,10,4,2,1,1,1,1,1
Malawi,197,7,1980,1980,190,47,6,4,4,3,1,1,3,1,2,2
Haiti,188,9,1980,1980,179,48,3,6,5,4,3,1,0,4,0,1
Guinea,187,16,1980,1980,171,49,5,9,8,8,3,1,1,4,1,4
Iraq,178,2,1980,1980,176,50,2,1,2,0,1,0,0,1,1,0
Guatemala,172,20,1980,1980,152,51,10,7,10,10,1,2,4,3,5,2
Ivory Coast,165,14,1980,1980,151,52,4,5,10,4,1,1,0,2,3,2
Japan,164,10,1980,1980,154,53,2,5,4,6,2,3,0,2,0,0
Tunisia,158,6,1980,1980,152,54,2,5,2,4,1,1,1,2,0,2
Egypt,155,6,1980,1980,149,55,3,2,4,2,2,0,1,1,0,1
Greece,154,7,1980,1980,147,56,5,6,4,3,0,1,2,4,3,1
Hong Kong,154,5,1980,1980,149,57,6,2,3,2,1,1,3,1,2,0
Suriname,151,5,1980,1980,146,58,2,2,4,1,1,1,0,1,1,0
El Salvador,149,17,1980,1980,132,59,5,7,13,4,5,1,0,2,0,4
Congo,148,8,1980,1980,140,60,5,1,6,2,2,1,1,0,2,0
Morocco,147,27,1980,1980,120,61,7,12,11,16,5,6,0,3,2,3
Tanzania,146,17,1980,1980,129,62,4,12,5,12,1,3,2,5,1,4
Israel,143,1,1980,1980,142,63,3,2,0,1,0,0,1,1,2,1
Bolivia,139,9,1980,1980,130,64,6,2,8,1,1,0,3,2,2,0
New Zealand,136,15,1980,1980,121,65,3,9,11,4,2,1,0,5,1,3
Ethiopia,134,3,1980,1980,131,66,2,1,3,0,1,0,0,1,1,0
Australia,127,33,1980,1980,94,67,10,5,20,13,2,2,4,1,4,2
Sudan,127,4,1980,1980,123,68,4,1,4,0,2,0,1,1,1,0
Algeria,116,15,1980,1980,101,69,6,4,11,4,4,0,0,2,2,2
Libya,112,10,1980,1980,102,70,3,3,5,5,2,2,0,0,1,1
Honduras,110,26,1980,1980,84,71,11,7,17,9,6,3,1,2,4,2
Cameroon,104,7,1980,1980,97,72,3,3,6,1,2,0,0,1,1,2
Mauritius,104,1,1980,1980,103,73,1,1,1,0,0,0,0,0,1,1
Mali,101,14,1980,1980,87,74,5,3,8,6,3,1,2,1,0,1
Panama,95,3,1980,1980,92,75,5,6,2,1,0,0,3,5,2,1
Senegal,93,18,1980,1980,75,76,5,8,6,12,3,5,2,2,0,1
Iran,90,15,1980,1980,75,77,1,5,0,15,0,3,0,1,1,1
USA,86,7,1980,1980,79,78,2,4,2,5,1,1,0,2,1,1
Iceland,84,13,1980,1980,71,79,5,4,8,5,2,1,2,2,1,1
Luxembourg,68,4,1980,1980,64,80,3,7,0,4,0,2,3,5,0,0
Togo,58,4,1980,1980,54,81,2,3,1,3,0,2,2,1,0,0
Madagascar,57,7,1980,1980,50,82,4,3,4,3,1,0,0,1,3,2
Canada,55,12,1980,1980,43,83,4,4,10,2,3,1,0,1,1,2
Saudi Arabia,54,14,1980,1980,40,84,4,4,12,2,2,1,1,3,1,0
Bahrain,53,3,1980,1980,50,85,3,1,3,0,0,0,2,1,1,0
Cuba,53,9,1980,1980,44,86,2,4,4,5,2,1,0,1,0,2
Syria,47,3,1980,1980,44,87,1,3,1,2,1,1,0,0,0,2
Sierra Leone,43,9,1980,1980,34,88,4,2,8,1,1,0,2,2,1,0
Fiji,37,9,1980,1980,28,89,5,1,8,1,2,0,2,1,1,0
Guyana,33,9,1980,1980,24,90,3,5,5,4,1,1,2,3,0,1
Zimbabwe,33,19,1980,1980,14,91,6,6,12,7,3,3,1,2,2,1
Grenada,31,4,1980,1980,27,92,1,1,2,2,0,0,1,1,0,0
Cyprus,24,3,1980,1980,21,93,4,1,3,0,0,0,3,1,1,0
Vanuatu,23,6,1980,1980,17,94,1,2,3,3,0,0,1,2,0,0
Liberia,22,2,1980,1980,20,95,3,3,1,1,0,0,0,2,3,1
Albania,20,3,1980,1980,17,96,2,2,2,1,1,0,1,2,0,0
Niger,20,3,1980,1980,17,97,2,3,0,3,0,1,1,1,1,1
Qatar,20,3,1980,1980,17,98,2,2,2,1,1,0,1,1,0,1
Somalia,18,2,1980,1980,16,99,2,2,2,0,0,0,0,1,2,1
Gambia,17,6,1980,1980,11,100,6,2,5,1,1,0,1,1,4,1
Mozambique,17,12,1980,1980,5,101,3,4,7,5,1,0,2,4,0,0
Guinea-Bissau,16,3,1980,1980,13,102,2,1,3,0,0,0,2,1,0,0
Malta,14,0,1980,1980,14,103,2,1,0,0,0,0,2,1,0,0
Lesotho,12,5,1980,1980,7,104,2,2,3,2,1,0,0,2,1,0
Bangladesh,10,0,1980,1980,10,105,2,1,0,0,0,0,2,1,0,0
Mauritania,9,7,1980,1980,2,106,3,4,4,3,1,1,2,2,0,1
United Arab Emirates,8,3,1980,1980,5,107,3,3,0,3,0,0,3,2,0,1
Faroe Islands,7,7,1980,1980,0,108,1,1,6,1,1,0,0,1,0,0
Macau,2,0,1980,1980,2,109,1,2,0,0,0,0,1,2,0,0
Northern Cyprus,0,0,1980,1980,0,110,1,1,0,0,0,0,1,1,0,0
Germany,1401,49,1981,1980.1,1352,1,8,9,34,15,6,5,2,3,0,1
Hungary,1271,16,1981,1980.1,1255,2,4,5,9,7,3,2,1,1,0,2
Sweden,1267,17,1981,1980.1,1250,3,5,6,7,10,4,3,1,3,0,0
England,1020,7,1981,1980.1,1013,4,6,3,2,5,1,1,3,2,2,0
Scotland,856,11,1981,1980.1,845,5,4,5,8,3,3,2,0,2,1,1
Austria,849,8,1981,1980.1,841,6,4,2,8,0,2,0,1,1,1,1
Brazil,807,36,1981,1980.1,771,7,6,10,18,18,6,6,0,1,0,3
Denmark,794,19,1981,1980.1,775,8,4,4,10,9,4,4,0,0,0,0
Netherlands,750,12,1981,1980.1,738,9,5,3,10,2,3,1,0,2,2,0
Belgium,702,8,1981,1980.1,694,10,3,3,6,2,3,0,0,3,0,0
France,657,12,1981,1980.1,645,11,4,4,10,2,3,0,1,4,0,0
Czech Republic,649,15,1981,1980.1,634,12,4,5,9,6,2,1,1,2,1,2
Italy,647,7,1981,1980.1,640,13,4,3,5,2,2,0,0,2,2,1
Uruguay,645,11,1981,1980.1,634,14,5,3,8,3,3,1,1,0,1,2
Poland,624,30,1981,1980.1,594,15,5,8,12,18,3,6,2,2,0,0
Norway,613,11,1981,1980.1,602,16,5,5,8,3,1,0,2,5,2,0
Switzerland,564,10,1981,1980.1,554,17,4,4,6,4,2,2,0,1,2,1
South Korea,554,17,1981,1980.1,537,18,6,6,14,3,5,2,0,3,1,1
Wales,464,8,1981,1980.1,456,19,3,5,4,4,1,2,0,2,2,1
Russia,442,13,1981,1980.1,429,20,3,3,9,4,3,1,0,0,0,2
Paraguay,422,3,1981,1980.1,419,21,3,2,3,0,1,0,2,2,0,0
Spain,417,15,1981,1980.1,402,22,4,8,6,9,3,3,1,2,0,3
Bulgaria,407,26,1981,1980.1,381,23,4,12,10,16,3,5,0,5,1,2
Finland,401,10,1981,1980.1,391,24,5,4,8,2,3,0,2,4,0,0
Mexico,380,11,1981,1980.1,369,25,5,2,10,1,2,0,1,0,2,2
Chile,375,17,1981,1980.1,358,26,7,6,11,6,4,3,1,1,2,2
Northern Ireland,372,3,1981,1980.1,369,27,3,3,2,1,2,0,0,2,1,1
Indonesia,363,18,1981,1980.1,345,28,13,5,18,0,5,0,6,4,2,1
Romania,359,7,1981,1980.1,352,29,5,5,5,2,2,0,2,3,1,2
Zambia,356,25,1981,1980.1,331,30,6,8,11,14,3,4,0,4,3,0
Malaysia,341,13,1981,1980.1,328,31,11,6,11,2,2,0,6,5,3,1
Ghana,336,10,1981,1980.1,326,32,2,6,3,7,0,3,0,1,2,2
Thailand,288,18,1981,1980.1,270,33,3,9,5,13,3,3,0,4,0,2
Peru,284,7,1981,1980.1,277,34,4,3,4,3,1,1,2,1,1,1
Portugal,270,11,1981,1980.1,259,35,5,4,8,3,3,0,1,4,1,0
China,268,9,1981,1980.1,259,36,3,4,5,4,2,1,0,2,1,1
Kenya,267,15,1981,1980.1,252,37,6,5,11,4,4,2,2,2,0,1
Ireland,258,9,1981,1980.1,249,38,3,3,7,2,2,0,1,2,0,1
Nigeria,246,12,1981,1980.1,234,39,5,7,5,7,3,1,1,4,1,2
Curaçao,237,3,1981,1980.1,234,40,1,1,3,0,1,0,0,1,0,0
Trinidad and Tobago,232,20,1981,1980.1,212,41,7,3,16,4,4,1,1,0,2,2
Uganda,230,9,1981,1980.1,221,42,4,2,6,3,2,0,1,1,1,1
Singapore,224,6,1981,1980.1,218,43,4,6,2,4,0,2,2,4,2,0
Malawi,223,26,1981,1980.1,197,44,7,6,15,11,5,2,1,2,1,2
Democratic Republic of the Congo,214,17,1981,1980.1,197,45,3,7,4,13,2,1,1,2,0,4
Iraq,208,30,1981,1980.1,178,46,8,5,24,6,6,3,0,1,2,1
Turkey,203,0,1981,1980.1,203,47,3,2,0,0,0,0,3,2,0,0
Guinea,198,11,1981,1980.1,187,48,4,7,6,5,2,1,0,2,2,4
Haiti,190,2,1981,1980.1,188,49,4,4,1,1,0,0,1,3,3,1
Japan,181,17,1981,1980.1,164,50,9,10,8,9,2,4,6,4,1,2
New Zealand,180,44,1981,1980.1,136,51,8,10,27,17,4,6,2,0,2,4
Tunisia,175,17,1981,1980.1,158,52,4,5,6,11,2,3,1,0,1,2
Morocco,165,18,1981,1980.1,147,53,7,5,12,6,4,1,1,3,2,1
Greece,164,10,1981,1980.1,154,54,3,3,6,4,2,2,1,0,0,1
Egypt,162,7,1981,1980.1,155,55,2,2,2,5,1,1,0,1,1,0
Kuwait,158,20,1981,1980.1,138,56,6,3,17,3,5,2,0,1,1,0
Tanzania,156,10,1981,1980.1,146,57,4,5,5,5,2,2,1,2,1,1
El Salvador,155,6,1981,1980.1,149,58,2,6,5,1,2,1,0,1,0,4
Suriname,154,3,1981,1980.1,151,59,1,1,1,2,0,0,0,1,1,0
Congo,153,5,1981,1980.1,148,60,2,3,2,3,0,0,1,1,1,2
Israel,150,7,1981,1980.1,143,61,3,2,6,1,2,0,1,2,0,0
Australia,149,22,1981,1980.1,127,62,4,3,15,7,3,1,1,1,0,1
Bolivia,145,6,1981,1980.1,139,63,3,2,5,1,1,0,2,2,0,0
India,145,8,1981,1980.1,137,64,4,3,5,3,2,0,1,2,1,1
Ethiopia,141,7,1981,1980.1,134,65,5,2,5,2,2,0,0,1,3,1
Algeria,139,23,1981,1980.1,116,66,5,4,20,3,5,1,0,2,0,1
Sudan,130,3,1981,1980.1,127,67,3,2,2,1,0,0,1,1,2,1
Cameroon,129,25,1981,1980.1,104,68,5,5,19,6,5,1,0,2,0,2
Ecuador,128,3,1981,1980.1,125,69,4,2,2,1,1,0,2,2,1,0
Mali,114,13,1981,1980.1,101,70,6,1,12,1,4,0,0,1,2,0
Colombia,113,9,1981,1980.1,104,71,5,4,5,4,0,1,1,3,4,0
Senegal,102,9,1981,1980.1,93,72,3,6,2,7,1,3,1,3,1,0
Iceland,93,9,1981,1980.1,84,73,3,3,6,3,2,0,0,2,1,1
Guadeloupe,81,9,1981,1980.1,72,74,2,2,5,4,1,1,1,0,0,1
Luxembourg,69,1,1981,1980.1,68,75,2,3,1,0,0,0,2,3,0,0
Saudi Arabia,69,15,1981,1980.1,54,76,11,3,13,2,6,0,5,2,0,1
Madagascar,66,9,1981,1980.1,57,77,2,4,2,7,1,2,0,2,1,0
Canada,65,10,1981,1980.1,55,78,2,4,2,8,1,1,0,1,1,2
Togo,62,4,1981,1980.1,58,79,2,2,4,0,1,0,0,2,1,0
Cuba,57,4,1981,1980.1,53,80,2,5,2,2,0,1,0,4,2,0
Bahrain,55,2,1981,1980.1,53,81,2,4,1,1,1,1,1,3,0,0
Zimbabwe,55,22,1981,1980.1,33,82,3,10,6,16,2,5,1,2,0,3
Syria,49,2,1981,1980.1,47,83,1,4,0,2,0,0,1,4,0,0
Burkina Faso,46,2,1981,1980.1,44,84,1,3,1,1,0,0,0,3,1,0
Fiji,43,6,1981,1980.1,37,85,4,3,3,3,1,0,2,2,1,1
Barbados,31,3,1981,1980.1,28,86,1,3,1,2,0,0,0,1,1,2
Dominica,27,2,1981,1980.1,25,87,1,1,2,0,0,0,1,1,0,0
Liberia,27,5,1981,1980.1,22,88,4,2,4,1,2,0,1,2,1,0
Cyprus,26,2,1981,1980.1,24,89,2,3,0,2,0,0,2,3,0,0
Mozambique,26,9,1981,1980.1,17,90,3,3,5,4,0,1,2,2,1,0
Pakistan,26,4,1981,1980.1,22,91,1,2,1,3,1,1,0,1,0,0
Qatar,25,5,1981,1980.1,20,92,3,2,5,0,2,0,1,2,0,0
Niger,23,3,1981,1980.1,20,93,2,2,3,0,2,0,0,2,0,0
Albania,21,1,1981,1980.1,20,94,2,2,0,1,0,0,2,2,0,0
Malta,21,7,1981,1980.1,14,95,2,5,3,4,1,2,1,2,0,1
Venezuela,21,4,1981,1980.1,17,96,5,3,3,1,3,0,2,3,0,0
Guinea-Bissau,20,4,1981,1980.1,16,97,2,1,4,0,1,0,1,1,0,0
United Arab Emirates,20,12,1981,1980.1,8,98,3,5,6,6,2,2,1,3,0,0
Gambia,19,2,1981,1980.1,17,99,1,1,1,1,0,0,0,1,1,0
Jordan,18,4,1981,1980.1,14,100,2,4,0,4,0,2,2,2,0,0
Lesotho,16,4,1981,1980.1,12,101,3,1,3,1,0,0,3,0,0,1
Angola,8,2,1981,1980.1,6,102,1,2,1,1,0,1,0,0,1,1
Burundi,5,3,1981,1980.1,2,103,2,1,1,2,0,0,2,0,0,1
Cape Verde,4,4,1981,1980.1,0,104,3,1,4,0,1,0,2,1,0,0
Liechtenstein,4,4,1981,1980.1,0,105,2,1,1,3,0,1,1,0,1,0
Rwanda,1,1,1981,1980.1,0,106,1,1,1,0,1,0,0,1,0,0
Germany,1437,36,1982,1980.2,1401,1,10,15,19,17,6,5,1,6,3,4
Hungary,1295,24,1982,1980.2,1271,2,4,5,18,6,2,2,2,2,0,1
Sweden,1277,10,1982,1980.2,1267,3,2,7,3,7,0,1,0,3,2,3
England,1054,34,1982,1980.2,1020,4,7,8,22,12,6,4,1,0,0,4
Argentina,989,20,1981,1980.1,969,5,6,3,13,7,4,2,0,1,2,0
Argentina,1002,13,1982,1980.2,989,5,9,1,12,1,4,0,2,1,3,0
Scotland,872,16,1982,1980.2,856,6,5,6,10,6,4,0,1,4,0,2
Austria,871,22,1982,1980.2,849,7,7,4,16,6,5,3,1,1,1,0
Brazil,838,31,1982,1980.2,807,8,9,2,26,5,7,1,0,1,2,0
Denmark,805,11,1982,1980.2,794,9,5,4,8,3,2,1,1,3,2,0
Netherlands,762,12,1982,1980.2,750,10,3,4,4,8,2,1,1,2,0,1
Belgium,717,15,1982,1980.2,702,11,7,4,14,1,5,1,1,2,1,1
France,682,25,1982,1980.2,657,12,9,5,16,9,5,2,3,2,1,1
Czech Republic,663,14,1982,1980.2,649,13,3,8,5,9,1,1,0,3,2,4
Italy,662,15,1982,1980.2,647,14,9,4,12,3,3,1,1,2,5,1
Poland,643,19,1982,1980.2,624,15,6,4,11,8,3,2,1,1,2,1
Norway,621,8,1982,1980.2,613,16,4,3,6,2,2,0,1,2,1,1
Switzerland,578,14,1982,1980.2,564,17,4,6,8,6,3,3,0,2,1,1
South Korea,575,21,1982,1980.2,554,18,5,6,14,7,4,1,0,1,1,4
Wales,470,6,1982,1980.2,464,19,3,3,4,2,2,1,1,1,0,1
Russia,456,14,1982,1980.2,442,20,4,6,8,6,3,2,0,1,1,3
Bulgaria,430,23,1982,1980.2,407,21,4,5,12,11,1,1,1,3,2,1
Spain,429,12,1982,1980.2,417,22,8,1,9,3,3,0,2,0,3,1
Finland,414,13,1982,1980.2,401,23,6,3,10,3,2,0,3,2,1,1
Chile,381,6,1982,1980.2,375,24,3,3,3,3,2,0,1,3,0,0
Northern Ireland,379,7,1982,1980.2,372,25,2,9,2,5,1,1,0,5,1,3
Zambia,370,14,1982,1980.2,356,26,1,7,2,12,1,4,0,2,0,1
Ghana,369,33,1982,1980.2,336,27,9,9,14,19,4,5,0,0,5,4
Romania,369,10,1982,1980.2,359,28,3,5,6,4,3,1,0,3,0,1
Indonesia,367,4,1982,1980.2,363,29,2,2,2,2,0,1,0,1,2,0
Malaysia,353,12,1982,1980.2,341,30,4,6,6,6,2,2,1,3,1,1
Thailand,295,7,1982,1980.2,288,31,6,5,5,2,1,0,2,2,3,3
Peru,292,8,1982,1980.2,284,32,2,6,1,7,1,2,0,2,1,2
Portugal,279,9,1982,1980.2,270,33,1,5,2,7,1,2,0,3,0,0
China,278,10,1982,1980.2,268,34,6,4,7,3,1,1,2,2,3,1
Kenya,272,5,1982,1980.2,267,35,2,1,4,1,2,0,0,0,0,1
Ireland,265,7,1982,1980.2,258,36,2,5,5,2,1,0,0,5,1,0
Nigeria,250,4,1982,1980.2,246,37,1,2,0,4,0,1,1,1,0,0
Singapore,250,26,1982,1980.2,224,38,7,8,17,9,5,2,2,4,0,2
Trinidad and Tobago,247,15,1982,1980.2,232,39,5,2,11,4,2,0,2,0,1,2
Uganda,243,13,1982,1980.2,230,40,5,5,8,5,3,1,0,2,2,2
Malawi,233,10,1982,1980.2,223,41,5,2,7,3,3,1,1,1,1,0
Guinea,206,8,1982,1980.2,198,42,4,5,6,2,2,1,0,1,2,3
Turkey,204,1,1982,1980.2,203,43,1,2,1,0,1,0,0,2,0,0
New Zealand,186,6,1982,1980.2,180,44,2,4,2,4,0,1,2,3,0,0
Japan,183,2,1982,1980.2,181,45,1,1,2,0,1,0,0,1,0,0
Tunisia,181,6,1982,1980.2,175,46,5,3,5,1,2,0,3,2,0,1
Ivory Coast,176,11,1982,1980.2,165,47,3,2,3,8,0,0,0,0,3,2
Greece,171,7,1982,1980.2,164,48,6,4,3,4,1,1,5,2,0,1
Morocco,171,6,1982,1980.2,165,49,1,3,2,4,1,0,0,1,0,2
Kuwait,169,11,1982,1980.2,158,50,4,6,4,7,2,3,1,2,1,1
Tanzania,162,6,1982,1980.2,156,51,2,7,1,5,0,2,1,4,1,1
El Salvador,160,5,1982,1980.2,155,52,1,4,3,2,1,0,0,3,0,1
Algeria,154,15,1982,1980.2,139,53,9,3,11,4,4,3,3,0,2,0
Hong Kong,154,0,1982,1980.2,154,54,1,2,0,0,0,0,0,2,1,0
India,150,5,1982,1980.2,145,55,5,4,5,0,0,0,1,3,4,1
Ethiopia,143,2,1982,1980.2,141,56,6,1,2,0,1,0,4,0,1,1
Cameroon,136,7,1982,1980.2,129,57,6,5,6,1,2,0,0,0,4,5
Mali,129,15,1982,1980.2,114,58,4,5,9,6,2,2,1,2,1,1
Senegal,117,15,1982,1980.2,102,59,4,13,5,10,3,2,1,4,0,7
Honduras,116,6,1982,1980.2,110,60,2,4,2,4,0,1,0,1,2,2
Mauritius,107,3,1982,1980.2,104,61,1,1,2,1,1,0,0,0,0,1
Iceland,106,13,1982,1980.2,93,62,3,7,2,11,0,2,1,4,2,1
Saudi Arabia,78,9,1982,1980.2,69,63,5,3,6,3,3,0,1,1,1,2
Togo,75,13,1982,1980.2,62,64,3,5,7,6,2,3,0,1,1,1
Luxembourg,70,1,1982,1980.2,69,65,2,1,1,0,0,0,2,1,0,0
Zimbabwe,68,13,1982,1980.2,55,66,4,8,5,8,1,2,2,3,1,3
Bahrain,65,10,1982,1980.2,55,67,5,3,7,3,2,1,1,2,2,0
Burkina Faso,51,5,1982,1980.2,46,68,2,4,1,4,0,1,0,2,2,1
Sierra Leone,45,2,1982,1980.2,43,69,1,5,0,2,0,1,1,4,0,0
Benin,38,9,1982,1980.2,29,70,4,2,7,2,1,0,2,1,1,1
Niger,29,6,1982,1980.2,23,71,1,6,0,6,0,0,0,2,1,4
Cyprus,28,2,1982,1980.2,26,72,2,2,1,1,0,0,1,2,1,0
Gambia,25,6,1982,1980.2,19,73,3,2,5,1,2,0,0,2,1,0
Malta,24,3,1982,1980.2,21,74,4,1,3,0,1,0,2,1,1,0
Albania,21,0,1982,1980.2,21,75,1,2,0,0,0,0,0,2,1,0
Bermuda,20,9,1982,1980.2,11,76,2,4,4,5,0,0,0,2,2,2
Réunion,18,4,1982,1980.2,14,77,2,1,1,3,0,1,1,0,1,0
Angola,10,2,1982,1980.2,8,78,1,1,1,1,0,0,1,1,0,0
Oman,9,6,1982,1980.2,3,79,1,7,0,6,0,2,1,5,0,0
Nepal,5,5,1982,1980.2,0,80,4,1,4,1,2,0,2,0,0,1
Brunei,0,0,1982,1980.2,0,81,1,1,0,0,0,0,1,1,0,0
Germany,1471,34,1983,1980.3,1437,1,11,10,25,9,8,3,3,4,0,3
Hungary,1316,21,1983,1980.3,1295,2,5,7,10,11,2,2,2,3,1,2
Sweden,1310,33,1983,1980.3,1277,3,5,7,11,22,3,6,1,1,1,0
England,1069,15,1983,1980.3,1054,4,5,6,6,9,3,3,1,0,1,3
Argentina,1010,8,1983,1980.3,1002,5,4,4,4,4,2,0,0,1,2,3
Scotland,885,13,1983,1980.3,872,6,4,6,5,8,1,3,0,3,3,0
Austria,877,6,1983,1980.3,871,7,2,4,2,4,0,1,0,3,2,0
Brazil,859,21,1983,1980.3,838,8,5,9,9,12,2,3,0,2,3,4
Denmark,821,16,1983,1980.3,805,9,4,3,13,3,4,2,0,1,0,0
Netherlands,776,14,1983,1980.3,762,10,4,3,10,4,3,1,1,1,0,1
Belgium,725,8,1983,1980.3,717,11,3,3,4,4,1,1,0,1,2,1
France,689,7,1983,1980.3,682,12,2,3,2,5,0,1,0,1,2,1
Czech Republic,675,12,1983,1980.3,663,13,4,4,10,2,2,1,1,1,1,2
Italy,669,7,1983,1980.3,662,14,3,4,6,1,2,0,1,3,0,1
Uruguay,664,19,1983,1980.3,645,15,7,8,12,7,4,2,0,2,3,4
Poland,650,7,1983,1980.3,643,16,5,1,7,0,1,0,1,1,3,0
South Korea,594,19,1983,1980.3,575,17,5,7,10,9,5,1,0,2,0,4
Switzerland,588,10,1983,1980.3,578,18,5,6,4,6,1,1,2,3,2,2
Wales,479,9,1983,1980.3,470,19,4,4,7,2,2,1,1,2,1,1
Russia,472,16,1983,1980.3,456,20,2,7,7,9,2,3,0,1,0,3
Spain,450,21,1983,1980.3,429,21,3,4,15,6,3,2,0,1,0,1
Bulgaria,442,12,1983,1980.3,430,22,1,7,1,11,1,4,0,3,0,0
Paraguay,437,15,1983,1980.3,422,23,5,8,7,8,3,2,0,3,2,3
Finland,416,2,1983,1980.3,414,24,2,3,0,2,0,0,2,2,0,1
Chile,407,26,1983,1980.3,381,25,7,8,18,8,5,2,0,4,2,2
Mexico,400,20,1983,1980.3,380,26,3,4,8,12,3,3,0,0,0,1
Northern Ireland,388,9,1983,1980.3,379,27,6,3,8,1,4,1,1,1,1,1
Romania,384,15,1983,1980.3,369,28,4,9,5,10,3,3,1,1,0,5
Ghana,383,14,1983,1980.3,369,29,8,3,12,2,6,1,1,2,1,0
Zambia,371,1,1983,1980.3,370,30,1,1,0,1,0,0,0,1,1,0
Indonesia,368,1,1983,1980.3,367,31,3,1,1,0,0,0,3,1,0,0
Malaysia,362,9,1983,1980.3,353,32,4,1,8,1,1,1,0,0,3,0
Peru,302,10,1983,1980.3,292,33,6,6,4,6,2,0,3,2,1,4
Kenya,288,16,1983,1980.3,272,34,11,2,14,2,7,0,1,0,3,2
Portugal,287,8,1983,1980.3,279,35,6,2,7,1,3,1,2,1,1,0
China,282,4,1983,1980.3,278,36,1,2,2,2,1,1,0,1,0,0
Ireland,279,14,1983,1980.3,265,37,2,3,10,4,1,2,1,1,0,0
Costa Rica,267,6,1983,1980.3,261,38,4,1,6,0,2,0,1,1,1,0
Singapore,261,11,1983,1980.3,250,39,4,2,7,4,2,1,2,0,0,1
Nigeria,258,8,1983,1980.3,250,40,6,9,4,4,1,3,1,3,4,3
Uganda,254,11,1983,1980.3,243,41,2,8,1,10,0,4,2,3,0,1
Trinidad and Tobago,250,3,1983,1980.3,247,42,1,2,0,3,0,1,1,1,0,0
Malawi,242,9,1983,1980.3,233,43,8,5,7,2,3,1,2,2,3,2
Guinea,216,10,1983,1980.3,206,44,4,6,5,5,1,0,1,5,2,1
Turkey,213,9,1983,1980.3,204,45,5,4,5,4,2,0,1,3,2,1
New Zealand,194,8,1983,1980.3,186,46,2,4,3,5,1,3,0,1,1,0
Ivory Coast,191,15,1983,1980.3,176,47,10,2,13,2,6,1,2,1,2,0
Tunisia,191,10,1983,1980.3,181,48,5,3,7,3,3,2,1,1,1,0
Japan,187,4,1983,1980.3,183,49,2,1,2,2,1,0,0,0,1,1
Greece,184,13,1983,1980.3,171,50,6,5,9,4,2,1,3,3,1,1
Algeria,175,21,1983,1980.3,154,51,9,1,21,0,7,0,2,0,0,1
Guatemala,175,3,1983,1980.3,172,52,4,1,3,0,1,0,2,0,1,1
Morocco,175,4,1983,1980.3,171,53,2,5,4,0,1,0,0,3,1,2
Egypt,173,11,1983,1980.3,162,54,5,7,8,3,4,0,1,3,0,4
Ethiopia,168,25,1983,1980.3,143,55,14,6,22,3,6,0,5,5,3,1
Tanzania,166,4,1983,1980.3,162,56,4,3,3,1,1,0,0,1,3,2
Congo,165,12,1983,1980.3,153,57,3,4,5,7,2,3,0,1,1,0
Martinique,158,21,1983,1980.3,137,58,3,2,14,7,2,2,0,0,1,0
Australia,156,7,1983,1980.3,149,59,5,2,2,5,0,1,3,1,2,0
Bolivia,155,10,1983,1980.3,145,60,5,3,5,5,1,0,3,2,1,1
Cameroon,150,14,1983,1980.3,136,61,4,4,12,2,3,0,0,3,1,1
Mali,144,15,1983,1980.3,129,62,5,11,5,10,1,3,2,3,2,5
Sudan,141,11,1983,1980.3,130,63,4,8,6,5,3,1,1,5,0,2
Ecuador,132,4,1983,1980.3,128,64,3,3,2,2,0,0,1,1,2,2
Senegal,132,15,1983,1980.3,117,65,6,9,5,10,4,3,1,4,1,2
Libya,124,12,1983,1980.3,112,66,3,6,9,3,3,1,0,4,0,1
Honduras,122,6,1983,1980.3,116,67,2,1,4,2,2,1,0,0,0,0
Colombia,120,7,1983,1980.3,113,68,4,3,6,1,0,1,0,1,4,1
Iceland,113,7,1983,1980.3,106,69,5,1,7,0,2,0,3,1,0,0
Mauritius,112,5,1983,1980.3,107,70,1,4,1,4,1,1,0,1,0,2
Togo,103,28,1983,1980.3,75,71,4,12,8,20,3,5,1,6,0,1
Guadeloupe,89,8,1983,1980.3,81,72,2,2,3,5,1,1,1,0,0,1
New Caledonia,88,12,1983,1980.3,76,73,3,2,9,3,3,0,0,2,0,0
Madagascar,76,10,1983,1980.3,66,74,3,4,2,8,1,3,1,0,1,1
Zimbabwe,76,8,1983,1980.3,68,75,1,7,3,5,1,3,0,3,0,1
Luxembourg,74,4,1983,1980.3,70,76,2,3,2,2,0,0,2,3,0,0
Canada,68,3,1983,1980.3,65,77,2,4,0,3,0,1,2,3,0,0
Syria,51,2,1983,1980.3,49,78,1,1,2,0,0,0,0,1,1,0
Sierra Leone,49,4,1983,1980.3,45,79,3,1,3,1,2,1,1,0,0,0
Benin,41,3,1983,1980.3,38,80,3,2,1,2,0,0,2,2,1,0
Guyana,36,3,1983,1980.3,33,81,2,2,2,1,1,0,0,1,1,1
Gambia,34,9,1983,1980.3,25,82,5,1,8,1,1,1,2,0,2,0
Niger,34,5,1983,1980.3,29,83,4,2,5,0,2,0,0,1,2,1
Barbados,33,2,1983,1980.3,31,84,4,1,2,0,1,0,1,1,2,0
Cyprus,31,3,1983,1980.3,28,85,3,3,2,1,0,0,1,3,2,0
Guinea-Bissau,29,9,1983,1980.3,20,86,4,4,5,4,2,1,1,2,1,1
Mozambique,29,3,1983,1980.3,26,87,1,3,3,0,1,0,0,2,0,1
Dominica,28,1,1983,1980.3,27,88,1,1,1,0,0,0,1,1,0,0
Liberia,28,1,1983,1980.3,27,89,1,3,0,1,0,0,1,2,0,1
Malta,28,4,1983,1980.3,24,90,3,5,3,1,0,0,3,5,0,0
Albania,25,4,1983,1980.3,21,91,3,2,3,1,0,0,2,2,1,0
Venezuela,22,1,1983,1980.3,21,92,2,2,1,0,0,0,1,2,1,0
Somalia,20,2,1983,1980.3,18,93,1,1,1,1,0,0,1,1,0,0
Antigua and Barbuda,16,11,1983,1980.3,5,94,4,2,8,3,1,1,2,0,1,1
Mauritania,15,6,1983,1980.3,9,95,7,2,5,1,2,0,4,1,1,1
Bangladesh,12,2,1983,1980.3,10,96,2,1,2,0,1,0,1,1,0,0
Angola,11,1,1983,1980.3,10,97,1,1,1,0,1,0,0,1,0,0
Cape Verde,5,1,1983,1980.3,4,98,1,1,1,0,1,0,0,1,0,0
Seychelles,4,2,1983,1980.3,2,99,1,2,1,1,0,0,1,1,0,1
St. Kitts and Nevis,2,0,1983,1980.3,2,100,1,1,0,0,0,0,1,1,0,0
Rwanda,1,0,1983,1980.3,1,101,1,1,0,0,0,0,1,1,0,0
Germany,1505,34,1984,1980.4,1471,1,12,8,19,15,8,5,2,3,2,0
Hungary,1336,20,1984,1980.4,1316,2,5,5,7,13,2,4,1,0,2,1
Sweden,1318,8,1984,1980.4,1310,3,4,4,5,3,1,1,2,2,1,1
England,1087,18,1984,1980.4,1069,4,4,7,7,11,3,2,1,3,0,2
Argentina,1021,11,1984,1980.4,1010,5,4,8,2,9,0,4,1,2,3,2
Scotland,894,9,1984,1980.4,885,6,4,1,9,0,3,0,0,1,1,0
Austria,888,11,1984,1980.4,877,7,2,5,1,10,1,2,0,3,1,0
Denmark,835,14,1984,1980.4,821,8,6,6,12,2,4,1,0,5,2,0
Netherlands,784,8,1984,1980.4,776,9,2,2,7,1,1,1,1,1,0,0
Belgium,733,8,1984,1980.4,725,10,4,5,5,3,1,1,2,3,1,1
France,713,24,1984,1980.4,689,11,10,1,20,4,10,1,0,0,0,0
Czech Republic,684,9,1984,1980.4,675,12,2,4,5,4,2,1,0,2,0,1
Italy,683,14,1984,1980.4,669,13,4,5,9,5,3,2,0,1,1,2
Uruguay,673,9,1984,1980.4,664,14,4,3,6,3,3,1,0,1,1,1
Poland,666,16,1984,1980.4,650,15,4,9,7,9,2,4,1,1,1,4
Norway,630,9,1984,1980.4,621,16,5,6,4,5,2,4,1,1,2,1
South Korea,616,22,1984,1980.4,594,17,8,3,20,2,4,1,2,1,2,1
Switzerland,592,4,1984,1980.4,588,18,6,2,3,1,1,1,2,1,3,0
Wales,484,5,1984,1980.4,479,19,3,5,4,1,2,0,0,4,1,1
Russia,482,10,1984,1980.4,472,20,1,5,3,7,1,2,0,2,0,1
Spain,466,16,1984,1980.4,450,21,3,9,5,11,2,3,1,2,0,4
Bulgaria,451,9,1984,1980.4,442,22,2,5,6,3,1,0,1,1,0,4
Finland,425,9,1984,1980.4,416,23,4,7,2,7,1,1,3,4,0,2
Mexico,419,19,1984,1980.4,400,24,4,12,7,12,3,4,0,3,1,5
Ghana,406,23,1984,1980.4,383,25,7,9,11,12,4,5,1,3,2,1
Romania,399,15,1984,1980.4,384,26,5,7,8,7,3,0,0,5,2,2
Northern Ireland,397,9,1984,1980.4,388,27,3,3,8,1,3,0,0,2,0,1
Malaysia,386,24,1984,1980.4,362,28,7,6,21,3,6,0,0,3,1,3
Zambia,385,14,1984,1980.4,371,29,4,8,8,6,3,2,0,3,1,3
Indonesia,382,14,1984,1980.4,368,30,8,1,12,2,4,0,4,0,0,1
China,320,38,1984,1980.4,282,31,12,10,26,12,8,5,4,5,0,0
Thailand,311,16,1984,1980.4,295,32,3,8,6,10,2,2,1,6,0,0
Peru,304,2,1984,1980.4,302,33,3,1,2,0,0,0,2,1,1,0
Kenya,302,14,1984,1980.4,288,34,7,6,7,7,3,0,3,4,1,2
Portugal,297,10,1984,1980.4,287,35,4,4,5,5,2,2,1,1,1,1
Ireland,281,2,1984,1980.4,279,36,3,4,1,1,1,1,0,3,2,0
Nigeria,269,11,1984,1980.4,258,37,1,7,3,8,1,2,0,2,0,3
Uganda,266,12,1984,1980.4,254,38,7,3,11,1,3,1,2,2,2,0
Singapore,265,4,1984,1980.4,261,39,6,1,4,0,1,0,3,1,2,0
Malawi,264,22,1984,1980.4,242,40,11,5,17,5,7,3,0,2,4,0
Trinidad and Tobago,262,12,1984,1980.4,250,41,5,1,10,2,3,1,2,0,0,0
Ivory Coast,244,53,1984,1980.4,191,42,16,7,39,14,11,4,2,2,3,1
Curaçao,237,0,1984,1980.4,237,43,1,1,0,0,0,0,0,1,1,0
Guinea,227,11,1984,1980.4,216,44,1,12,1,10,0,2,1,3,0,7
Iraq,222,14,1984,1980.4,208,45,5,4,9,5,2,3,1,0,2,1
Turkey,220,7,1984,1980.4,213,46,6,4,3,4,1,2,4,2,1,0
Democratic Republic of the Congo,217,3,1984,1980.4,214,47,1,1,2,1,1,0,0,0,0,1
Tunisia,206,15,1984,1980.4,191,48,3,3,11,4,3,1,0,2,0,0
New Zealand,205,11,1984,1980.4,194,49,3,2,8,3,2,1,0,0,1,1
Japan,197,10,1984,1980.4,187,50,1,2,1,9,1,2,0,0,0,0
Haiti,196,6,1984,1980.4,190,51,3,1,5,1,1,1,2,0,0,0
Algeria,193,18,1984,1980.4,175,52,9,2,14,4,5,0,1,2,3,0
Greece,193,9,1984,1980.4,184,53,6,5,6,3,1,1,2,3,3,1
Morocco,189,14,1984,1980.4,175,54,4,2,10,4,3,1,0,0,1,1
Egypt,186,13,1984,1980.4,173,55,11,4,8,5,4,2,4,1,3,1
Guatemala,185,10,1984,1980.4,175,56,4,4,8,2,4,0,0,4,0,0
Congo,180,15,1984,1980.4,165,57,6,3,14,1,3,0,2,3,1,0
Kuwait,180,11,1984,1980.4,169,58,7,7,7,4,3,1,3,2,1,4
Ethiopia,178,10,1984,1980.4,168,59,3,2,7,3,2,1,0,1,1,0
El Salvador,176,16,1984,1980.4,160,60,6,3,12,4,4,1,1,2,1,0
Tanzania,175,9,1984,1980.4,166,61,4,4,4,5,0,1,2,0,2,3
Cameroon,174,24,1984,1980.4,150,62,4,8,7,17,2,4,1,2,1,2
Suriname,168,14,1984,1980.4,154,63,3,3,11,3,3,0,0,0,0,3
India,164,14,1984,1980.4,150,64,8,10,9,5,3,1,5,8,0,1
Israel,160,10,1984,1980.4,150,65,5,3,8,2,3,0,0,1,2,2
Hong Kong,158,4,1984,1980.4,154,66,1,4,0,4,0,1,0,2,1,1
Mali,156,12,1984,1980.4,144,67,4,8,4,8,3,2,0,3,1,3
Senegal,153,21,1984,1980.4,132,68,2,13,2,19,2,4,0,5,0,4
Sudan,142,1,1984,1980.4,141,69,1,1,0,1,0,0,0,0,1,1
Honduras,130,8,1984,1980.4,122,70,3,3,2,6,2,2,0,1,1,0
Saudi Arabia,123,45,1984,1980.4,78,71,16,5,38,7,10,3,3,1,3,1
Colombia,121,1,1984,1980.4,120,72,1,3,1,0,1,0,0,2,0,1
Iran,120,30,1984,1980.4,90,73,8,5,25,5,6,2,0,1,2,2
Iceland,118,5,1984,1980.4,113,74,2,5,1,4,1,2,1,2,0,1
Togo,114,11,1984,1980.4,103,75,1,9,2,9,1,1,0,2,0,6
Mauritius,112,0,1984,1980.4,112,76,2,2,0,0,0,0,1,2,1,0
Panama,100,5,1984,1980.4,95,77,5,2,4,1,1,0,2,2,2,0
USA,97,11,1984,1980.4,86,78,6,3,10,1,3,0,0,2,3,1
Zimbabwe,95,19,1984,1980.4,76,79,4,10,7,12,3,2,0,6,1,2
Luxembourg,76,2,1984,1980.4,74,80,6,4,2,0,0,0,6,4,0,0
Canada,71,3,1984,1980.4,68,81,1,5,0,3,0,1,1,4,0,0
Bahrain,68,3,1984,1980.4,65,82,5,1,2,1,0,1,3,0,2,0
Syria,64,13,1984,1980.4,51,83,5,6,7,6,3,1,2,4,0,1
Sierra Leone,57,8,1984,1980.4,49,84,7,5,5,3,3,1,1,4,3,0
United Arab Emirates,54,34,1984,1980.4,20,85,5,10,28,6,5,3,0,4,0,3
Qatar,53,28,1984,1980.4,25,86,8,10,16,12,3,6,1,2,4,2
Benin,51,10,1984,1980.4,41,87,6,5,6,4,1,1,4,4,1,0
Gambia,51,17,1984,1980.4,34,88,11,7,13,4,4,1,4,4,3,2
Guyana,43,7,1984,1980.4,36,89,5,2,6,1,1,0,1,2,3,0
Liberia,40,12,1984,1980.4,28,90,7,5,8,4,2,1,3,4,2,0
Cyprus,35,4,1984,1980.4,31,91,5,1,3,1,1,0,4,0,0,1
Gabon,35,7,1984,1980.4,28,92,2,5,2,5,0,0,0,2,2,3
Niger,35,1,1984,1980.4,34,93,1,1,1,0,0,0,1,1,0,0
Mozambique,32,3,1984,1980.4,29,94,1,1,3,0,1,0,0,0,0,1
Malta,31,3,1984,1980.4,28,95,1,3,2,1,0,0,1,3,0,0
Albania,30,5,1984,1980.4,25,96,1,2,2,3,1,0,0,1,0,1
Pakistan,30,4,1984,1980.4,26,97,1,3,4,0,1,0,0,3,0,0
Sri Lanka,30,6,1984,1980.4,24,98,1,3,4,2,1,0,0,2,0,1
Jordan,25,7,1984,1980.4,18,99,2,2,7,0,1,0,0,2,1,0
Somalia,22,2,1984,1980.4,20,100,1,3,1,1,1,0,0,2,0,1
Oman,21,12,1984,1980.4,9,101,8,2,12,0,1,0,4,2,3,0
Mauritania,19,4,1984,1980.4,15,102,8,3,2,2,0,0,4,3,4,0
Bangladesh,18,6,1984,1980.4,12,103,1,4,3,3,1,0,0,4,0,0
Angola,16,5,1984,1980.4,11,104,2,2,2,3,2,1,0,1,0,0
Central African Republic,11,5,1984,1980.4,6,105,3,1,4,1,0,0,1,1,2,0
Swaziland,9,4,1984,1980.4,5,106,2,1,4,0,1,0,1,1,0,0
Puerto Rico,7,0,1984,1980.4,7,107,1,1,0,0,0,0,1,1,0,0
Cape Verde,6,1,1984,1980.4,5,108,2,1,1,0,0,0,1,1,1,0
Djibouti,4,1,1984,1980.4,3,109,2,1,1,0,0,0,2,1,0,0
Greenland,2,2,1984,1980.4,0,110,1,2,0,2,0,0,1,2,0,0
Germany,1543,38,1985,1980.5,1505,1,9,15,20,18,6,4,2,8,1,3
Hungary,1349,13,1985,1980.5,1336,2,3,5,3,10,2,4,1,1,0,0
Sweden,1331,13,1985,1980.5,1318,3,4,4,6,7,3,2,0,1,1,1
England,1106,19,1985,1980.5,1087,4,6,6,12,7,3,2,1,2,2,2
Argentina,1039,18,1985,1980.5,1021,5,5,7,9,9,3,2,0,3,2,2
Scotland,899,5,1985,1980.5,894,6,4,4,3,2,2,1,1,1,1,2
Austria,893,5,1985,1980.5,888,7,2,3,4,1,1,0,1,1,0,2
Brazil,875,16,1984,1980.4,859,8,7,4,11,5,4,2,1,2,2,0
Brazil,875,16,1985,1980.5,859,8,7,4,11,5,4,2,1,2,2,0
Denmark,852,17,1985,1980.5,835,9,4,4,8,9,2,2,1,2,1,0
Netherlands,796,12,1985,1980.5,784,10,4,2,11,1,3,1,0,1,1,0
Belgium,739,6,1985,1980.5,733,11,3,2,5,1,3,0,0,1,0,1
France,721,8,1985,1980.5,713,12,2,2,8,0,2,0,0,2,0,0
Uruguay,696,23,1985,1980.5,673,13,7,8,15,8,6,3,0,5,1,0
Czech Republic,693,9,1985,1980.5,684,14,4,4,7,2,3,0,1,2,0,2
Italy,691,8,1985,1980.5,683,15,2,5,3,5,1,2,1,1,0,2
Poland,680,14,1985,1980.5,666,16,3,12,3,11,2,3,0,6,1,3
South Korea,645,29,1985,1980.5,616,17,7,8,17,12,7,4,0,4,0,0
Norway,642,12,1985,1980.5,630,18,4,7,8,4,2,1,2,3,0,3
Switzerland,602,10,1985,1980.5,592,19,5,7,5,5,1,1,0,3,4,3
Russia,505,23,1985,1980.5,482,20,7,5,13,10,7,3,0,1,0,1
Wales,492,8,1985,1980.5,484,21,4,2,5,3,1,1,1,1,2,0
Spain,476,10,1985,1980.5,466,22,6,3,8,2,4,1,0,1,2,1
Bulgaria,465,14,1985,1980.5,451,23,4,7,6,8,3,2,0,4,1,1
Paraguay,457,20,1985,1980.5,437,24,8,10,11,9,4,1,3,4,1,5
Mexico,447,28,1985,1980.5,419,25,15,5,24,4,9,1,1,2,5,2
Chile,433,26,1985,1980.5,407,26,9,8,21,5,6,1,1,4,2,3
Finland,433,8,1985,1980.5,425,27,3,7,3,5,1,0,0,7,2,0
Ghana,414,8,1985,1980.5,406,28,5,5,3,5,1,1,1,3,3,1
Romania,412,13,1985,1980.5,399,29,5,5,5,8,2,2,1,1,2,2
Zambia,402,17,1985,1980.5,385,30,5,10,8,9,2,3,1,3,2,4
Northern Ireland,400,3,1985,1980.5,397,31,2,4,2,1,1,1,1,0,0,3
Indonesia,397,15,1985,1980.5,382,32,5,7,7,8,3,2,2,3,0,2
Malaysia,397,11,1985,1980.5,386,33,2,6,6,5,2,1,0,4,0,1
China,350,30,1985,1980.5,320,34,4,6,17,13,2,3,2,1,0,2
Peru,326,22,1985,1980.5,304,35,9,10,12,10,5,3,2,3,2,4
Thailand,320,9,1985,1980.5,311,36,4,5,4,5,1,1,2,3,1,1
Kenya,307,5,1985,1980.5,302,37,6,3,3,2,1,0,3,2,2,1
Portugal,307,10,1985,1980.5,297,38,3,4,6,4,1,2,2,2,0,0
Ireland,287,6,1985,1980.5,281,39,5,4,5,1,1,0,2,2,2,2
Malawi,287,23,1985,1980.5,264,40,8,7,8,15,3,2,1,2,4,3
Costa Rica,285,18,1985,1980.5,267,41,10,5,15,3,5,1,0,3,5,1
Nigeria,280,11,1985,1980.5,269,42,5,5,6,5,3,1,0,2,2,2
Singapore,274,9,1985,1980.5,265,43,4,1,9,0,3,0,1,1,0,0
Trinidad and Tobago,273,11,1985,1980.5,262,44,2,9,1,10,0,1,2,4,0,4
Uganda,271,5,1985,1980.5,266,45,1,4,3,2,1,1,0,2,0,1
Ivory Coast,266,22,1985,1980.5,244,46,11,10,16,6,5,3,2,4,4,3
Iraq,261,39,1985,1980.5,222,47,7,9,22,17,6,5,1,2,0,2
Guinea,236,9,1985,1980.5,227,48,7,6,6,3,3,0,3,3,1,3
Democratic Republic of the Congo,231,14,1985,1980.5,217,49,5,6,4,10,1,4,2,2,2,0
New Zealand,223,18,1985,1980.5,205,50,6,2,18,0,5,0,0,2,1,0
Turkey,222,2,1985,1980.5,220,51,3,6,2,0,0,0,1,4,2,2
Tunisia,217,11,1985,1980.5,206,52,7,5,9,2,6,1,1,4,0,0
Algeria,214,21,1985,1980.5,193,53,7,8,14,7,4,2,2,2,1,4
Japan,211,14,1985,1980.5,197,54,3,3,9,5,2,2,1,1,0,0
Greece,199,6,1985,1980.5,193,55,4,3,3,3,1,1,2,1,1,1
Morocco,198,9,1985,1980.5,189,56,5,6,8,1,4,1,1,1,0,4
Egypt,197,11,1985,1980.5,186,57,7,7,8,3,5,1,1,5,1,1
Haiti,196,0,1985,1980.5,196,58,2,2,0,0,0,0,2,2,0,0
Guatemala,193,8,1985,1980.5,185,59,3,4,6,2,2,1,0,2,1,1
Congo,190,10,1985,1980.5,180,60,4,5,5,5,2,1,2,3,0,1
Cameroon,189,15,1985,1980.5,174,61,5,7,8,7,3,1,0,5,2,1
Kuwait,189,9,1985,1980.5,180,62,4,2,6,3,1,1,0,1,3,0
El Salvador,185,9,1985,1980.5,176,63,4,2,8,1,3,0,1,1,0,1
Hong Kong,182,24,1985,1980.5,158,64,5,5,13,11,3,4,1,1,1,0
Suriname,174,6,1985,1980.5,168,65,1,9,0,6,0,2,1,4,0,3
Israel,173,13,1985,1980.5,160,66,6,2,11,2,2,0,2,1,2,1
Mali,172,16,1985,1980.5,156,67,5,6,11,5,2,2,0,3,3,1
Australia,171,15,1985,1980.5,156,68,5,3,13,2,3,1,0,1,2,1
India,171,7,1985,1980.5,164,69,4,3,4,3,1,1,1,1,2,1
Senegal,171,18,1985,1980.5,153,70,4,8,9,9,3,5,0,1,1,2
Bolivia,163,8,1985,1980.5,155,71,6,4,7,1,2,0,2,3,2,1
Martinique,163,5,1985,1980.5,158,72,1,2,2,3,1,1,0,0,0,1
Ecuador,147,15,1985,1980.5,132,73,6,3,12,3,3,0,2,3,1,0
Colombia,145,24,1985,1980.5,121,74,11,8,17,7,7,1,2,4,2,3
Honduras,142,12,1985,1980.5,130,75,6,3,7,5,3,1,1,1,2,1
Sudan,142,0,1985,1980.5,142,76,1,1,0,0,0,0,0,1,1,0
Libya,139,15,1985,1980.5,124,77,7,5,14,1,6,0,0,3,1,2
Saudi Arabia,133,10,1985,1980.5,123,78,6,3,9,1,3,0,1,3,2,0
Iceland,131,13,1985,1980.5,118,79,4,3,11,2,2,0,2,1,0,2
Togo,118,4,1985,1980.5,114,80,2,2,3,1,1,0,1,1,0,1
Zimbabwe,111,16,1985,1980.5,95,81,8,4,10,6,4,3,2,1,2,0
USA,103,6,1985,1980.5,97,82,6,2,5,1,2,0,2,1,2,1
Guadeloupe,96,7,1985,1980.5,89,83,3,3,4,3,0,2,1,0,2,1
Canada,91,20,1985,1980.5,71,84,7,10,12,8,5,3,1,1,1,6
Jamaica,84,3,1985,1980.5,81,85,2,1,1,2,0,0,0,0,2,1
Bahrain,79,11,1985,1980.5,68,86,7,2,11,0,3,0,1,2,3,0
Luxembourg,78,2,1985,1980.5,76,87,2,2,1,1,0,0,1,2,1,0
Madagascar,77,1,1985,1980.5,76,88,2,1,1,0,1,0,1,1,0,0
Qatar,77,24,1985,1980.5,53,89,4,6,20,4,4,1,0,3,0,2
Syria,74,10,1985,1980.5,64,90,6,4,7,3,4,1,1,1,1,2
United Arab Emirates,66,12,1985,1980.5,54,91,2,5,3,9,1,2,1,2,0,1
Gambia,55,4,1985,1980.5,51,92,6,1,4,0,2,0,2,1,2,0
Malta,38,7,1985,1980.5,31,93,4,2,5,2,1,0,2,2,1,0
Mozambique,37,5,1985,1980.5,32,94,3,2,4,1,1,0,1,1,1,1
Dominica,32,4,1985,1980.5,28,95,2,3,2,2,1,0,1,2,0,1
Albania,31,1,1985,1980.5,30,96,3,1,1,0,0,0,1,1,2,0
Guinea-Bissau,30,1,1985,1980.5,29,97,1,3,0,1,0,0,0,3,1,0
Jordan,29,4,1985,1980.5,25,98,4,4,3,1,1,0,2,4,1,0
Bangladesh,27,9,1985,1980.5,18,99,4,4,5,4,2,1,1,3,1,0
Venezuela,27,5,1985,1980.5,22,100,3,4,4,1,0,0,2,4,1,0
Angola,26,10,1985,1980.5,16,101,5,2,8,2,2,0,1,1,2,1
Mauritania,20,1,1985,1980.5,19,102,3,5,1,0,0,0,1,5,2,0
Cape Verde,12,6,1985,1980.5,6,103,5,1,4,2,1,1,2,0,2,0
Central African Republic,12,1,1985,1980.5,11,104,1,1,1,0,0,0,1,1,0,0
Chad,9,4,1985,1980.5,5,105,3,1,4,0,0,0,1,1,2,0
Brunei,7,7,1985,1980.5,0,106,5,4,6,1,1,0,4,4,0,0
Macau,6,4,1985,1980.5,2,107,3,4,2,2,1,1,2,3,0,0
Nepal,5,0,1985,1980.5,5,108,2,3,0,0,0,0,1,3,1,0
St. Kitts and Nevis,5,3,1985,1980.5,2,109,1,1,2,1,1,1,0,0,0,0
Yemen,3,1,1985,1980.5,2,110,3,2,1,0,0,0,3,2,0,0
Germany,1573,30,1986,1980.6,1543,1,8,18,11,19,4,8,2,7,2,3
Hungary,1358,9,1986,1980.6,1349,2,4,4,5,4,2,1,2,2,0,1
Sweden,1343,12,1986,1980.6,1331,3,4,4,3,9,2,2,0,1,2,1
England,1129,23,1986,1980.6,1106,4,5,8,11,12,4,5,0,3,1,0
Argentina,1053,14,1986,1980.6,1039,5,6,3,13,1,6,0,0,2,0,1
Scotland,908,9,1986,1980.6,899,6,5,5,6,3,2,1,1,2,2,2
Austria,903,10,1986,1980.6,893,7,4,2,9,1,3,0,0,2,1,0
Brazil,896,21,1986,1980.6,875,8,7,4,17,4,5,2,0,2,2,0
Denmark,867,15,1986,1980.6,852,9,6,7,11,4,4,2,2,2,0,3
Netherlands,801,5,1986,1980.6,796,10,2,5,0,5,0,3,0,2,2,0
Belgium,762,23,1986,1980.6,739,11,3,9,5,18,1,3,0,4,2,2
France,735,14,1986,1980.6,721,12,6,7,7,7,2,3,2,1,2,3
Italy,708,17,1986,1980.6,691,13,7,3,11,6,4,2,2,0,1,1
Czech Republic,706,13,1986,1980.6,693,14,5,4,6,7,3,3,1,0,1,1
Uruguay,705,9,1986,1980.6,696,15,2,8,3,6,0,1,0,3,2,4
Poland,686,6,1986,1980.6,680,16,3,7,4,2,3,0,0,4,0,3
South Korea,667,22,1986,1980.6,645,17,7,6,15,7,3,1,3,4,1,1
Norway,658,16,1986,1980.6,642,18,5,6,4,12,2,4,0,2,3,0
Switzerland,610,8,1986,1980.6,602,19,4,4,5,3,2,0,1,3,1,1
Russia,525,20,1986,1980.6,505,20,6,7,15,5,3,1,2,3,1,3
Spain,503,27,1986,1980.6,476,21,7,5,13,14,5,4,1,0,1,1
Wales,499,7,1986,1980.6,492,22,1,5,0,7,0,3,0,1,1,1
Paraguay,477,20,1986,1980.6,457,23,2,10,3,17,1,5,0,1,1,4
Bulgaria,475,10,1986,1980.6,465,24,3,8,5,5,1,0,1,3,1,5
Finland,442,9,1986,1980.6,433,25,3,8,3,6,1,2,1,3,1,3
Romania,431,19,1986,1980.6,412,26,3,7,9,10,3,2,0,2,0,3
Ghana,429,15,1986,1980.6,414,27,9,1,15,0,6,0,1,1,2,0
Zambia,419,17,1986,1980.6,402,28,4,6,11,6,2,3,1,2,1,1
Malaysia,408,11,1986,1980.6,397,29,5,1,10,1,4,0,0,1,1,0
Northern Ireland,405,5,1986,1980.6,400,30,4,4,4,1,1,0,2,1,1,3
Indonesia,400,3,1986,1980.6,397,31,2,1,2,1,0,0,2,0,0,1
China,375,25,1986,1980.6,350,32,8,6,16,9,5,3,1,1,2,2
Thailand,323,3,1986,1980.6,320,33,1,4,1,2,0,1,0,3,1,0
Portugal,315,8,1986,1980.6,307,34,6,2,7,1,2,0,2,1,2,1
Kenya,312,5,1986,1980.6,307,35,2,1,4,1,1,0,1,1,0,0
Ireland,293,6,1986,1980.6,287,36,3,4,1,5,0,2,1,1,2,1
Malawi,289,2,1986,1980.6,287,37,5,1,2,0,1,0,2,1,2,0
Nigeria,282,2,1986,1980.6,280,38,1,1,2,0,0,0,0,1,1,0
Ivory Coast,280,14,1986,1980.6,266,39,3,7,7,7,3,3,0,4,0,0
Uganda,276,5,1986,1980.6,271,40,2,4,4,1,2,0,0,1,0,3
Iraq,271,10,1986,1980.6,261,41,4,6,4,6,0,1,3,2,1,3
Guinea,243,7,1986,1980.6,236,42,4,4,4,3,1,1,2,2,1,1
New Zealand,231,8,1986,1980.6,223,43,1,3,1,7,0,2,0,1,1,0
Algeria,230,16,1986,1980.6,214,44,8,7,11,5,3,1,2,3,3,3
Tunisia,222,5,1986,1980.6,217,45,2,2,4,1,0,0,0,1,2,1
Japan,216,5,1986,1980.6,211,46,2,1,4,1,2,0,0,1,0,0
Greece,210,11,1986,1980.6,199,47,3,6,4,7,2,2,0,3,1,1
Cameroon,208,19,1986,1980.6,189,48,3,7,5,14,2,5,0,0,1,2
Morocco,206,8,1986,1980.6,198,49,4,7,1,7,1,1,1,3,2,3
Congo,201,11,1986,1980.6,190,50,3,3,5,6,1,2,2,0,0,1
Kuwait,201,12,1986,1980.6,189,51,3,4,5,7,3,3,0,0,0,1
Ethiopia,190,12,1986,1980.6,178,52,1,3,4,8,1,2,0,0,0,1
Senegal,183,12,1986,1980.6,171,53,5,4,8,4,5,3,0,1,0,0
India,179,8,1986,1980.6,171,54,4,2,7,1,2,0,1,2,1,0
Australia,177,6,1986,1980.6,171,55,4,2,3,3,1,1,2,0,1,1
Saudi Arabia,148,15,1986,1980.6,133,56,8,4,6,9,1,3,4,1,3,0
Iceland,137,6,1986,1980.6,131,57,4,4,3,3,0,1,2,3,2,0
Iran,129,9,1986,1980.6,120,58,3,1,8,1,3,0,0,1,0,0
Togo,129,11,1986,1980.6,118,59,2,7,4,7,2,1,0,3,0,3
Mauritius,112,0,1986,1980.6,112,60,1,1,0,0,0,0,1,0,0,1
Panama,103,3,1986,1980.6,100,61,1,2,2,1,1,0,0,1,0,1
Canada,96,5,1986,1980.6,91,62,6,7,3,2,1,2,4,4,1,1
Bahrain,92,13,1986,1980.6,79,63,13,2,11,2,3,1,5,1,5,0
Qatar,88,11,1986,1980.6,77,64,10,2,10,1,3,0,4,1,3,1
Luxembourg,78,0,1986,1980.6,78,65,1,2,0,0,0,0,1,2,0,0
United Arab Emirates,76,10,1986,1980.6,66,66,2,4,2,8,0,3,1,1,1,0
Gambia,63,8,1986,1980.6,55,67,4,2,7,1,2,0,2,2,0,0
Burkina Faso,53,2,1986,1980.6,51,68,3,3,1,1,0,1,2,2,1,0
Liberia,47,7,1986,1980.6,40,69,7,2,7,0,3,0,2,2,2,0
Niger,41,6,1986,1980.6,35,70,1,5,3,3,1,1,0,3,0,1
Gabon,38,3,1986,1980.6,35,71,2,5,1,2,1,2,1,2,0,1
Mozambique,38,1,1986,1980.6,37,72,1,3,0,1,0,0,1,3,0,0
Cyprus,37,2,1986,1980.6,35,73,2,1,2,0,0,0,2,0,0,1
Pakistan,37,7,1986,1980.6,30,74,4,1,7,0,3,0,1,1,0,0
Guinea-Bissau,33,3,1986,1980.6,30,75,2,1,3,0,1,0,1,1,0,0
Albania,32,1,1986,1980.6,31,76,1,1,1,0,0,0,1,1,0,0
Oman,30,9,1986,1980.6,21,77,5,6,4,5,1,1,3,4,1,1
Angola,28,2,1986,1980.6,26,78,3,1,2,0,2,0,1,1,0,0
Somalia,23,1,1986,1980.6,22,79,1,1,0,1,0,0,0,1,1,0
Mauritania,21,1,1986,1980.6,20,80,1,2,0,1,0,0,1,2,0,0
Réunion,19,1,1986,1980.6,18,81,1,1,0,1,0,1,0,0,1,0
Nepal,17,12,1986,1980.6,5,82,5,3,12,0,3,0,1,3,1,0
Central African Republic,15,3,1986,1980.6,12,83,3,1,2,1,0,0,3,1,0,0
Chad,12,3,1986,1980.6,9,84,3,1,2,1,0,1,2,0,1,0
Botswana,6,3,1986,1980.6,3,85,1,3,2,1,1,1,0,2,0,0
Germany,1599,26,1987,1980.7,1573,1,10,9,15,11,6,3,0,4,4,2
Hungary,1370,12,1987,1980.7,1358,2,4,5,9,3,3,1,0,3,1,1
Sweden,1352,9,1987,1980.7,1343,3,4,5,3,6,3,1,1,1,0,3
England,1145,16,1987,1980.7,1129,4,2,5,9,7,1,2,0,1,1,2
Brazil,918,22,1987,1980.7,896,5,4,6,12,10,3,3,0,2,1,1
Scotland,914,6,1987,1980.7,908,6,5,3,4,2,2,1,2,1,1,1
Austria,911,8,1987,1980.7,903,7,2,4,2,6,0,2,1,1,1,1
Denmark,870,3,1987,1980.7,867,8,2,4,2,1,1,1,0,3,1,0
Netherlands,823,22,1987,1980.7,801,9,6,3,16,6,4,2,0,0,2,1
Belgium,769,7,1987,1980.7,762,10,2,5,7,0,2,0,0,3,0,2
France,740,5,1987,1980.7,735,11,3,3,3,2,1,0,1,2,1,1
Italy,722,14,1987,1980.7,708,12,3,6,10,4,3,2,0,1,0,3
Czech Republic,715,9,1987,1980.7,706,13,2,6,5,4,2,1,0,3,0,2
Uruguay,711,6,1987,1980.7,705,14,2,2,4,2,2,2,0,0,0,0
Poland,706,20,1987,1980.7,686,15,7,4,15,5,5,1,1,3,1,0
South Korea,675,8,1987,1980.7,667,16,4,3,6,2,2,1,0,1,2,1
Norway,664,6,1987,1980.7,658,17,5,4,2,4,1,0,2,3,2,1
Switzerland,622,12,1987,1980.7,610,18,6,3,9,3,2,1,1,0,3,2
Russia,536,11,1987,1980.7,525,19,5,3,9,2,3,1,1,0,1,2
Spain,519,16,1987,1980.7,503,20,5,2,12,4,3,1,1,1,1,0
Wales,505,6,1987,1980.7,499,21,4,2,6,0,2,0,0,2,2,0
Bulgaria,486,11,1987,1980.7,475,22,4,2,7,4,3,1,1,1,0,0
Paraguay,480,3,1987,1980.7,477,23,1,3,0,3,0,2,0,1,1,0
Mexico,457,10,1987,1980.7,447,24,2,1,7,3,2,1,0,0,0,0
Romania,450,19,1987,1980.7,431,25,4,5,13,6,3,2,0,1,1,2
Finland,448,6,1987,1980.7,442,26,3,2,5,1,1,0,2,2,0,0
Chile,447,14,1987,1980.7,433,27,4,4,7,7,3,2,1,2,0,0
Ghana,442,13,1987,1980.7,429,28,1,8,1,12,0,4,1,0,0,4
Zambia,425,6,1987,1980.7,419,29,2,3,4,2,2,1,0,2,0,0
Northern Ireland,407,2,1987,1980.7,405,30,2,1,1,1,1,0,1,0,0,1
Peru,331,5,1987,1980.7,326,31,3,2,4,1,1,0,1,1,1,1
Thailand,328,5,1987,1980.7,323,32,2,2,2,3,1,0,1,1,0,1
Portugal,321,6,1987,1980.7,315,33,5,3,4,2,1,2,1,1,3,0
Kenya,320,8,1987,1980.7,312,34,3,3,5,3,2,0,0,2,1,1
Ireland,307,14,1987,1980.7,293,35,5,3,10,4,4,2,0,1,1,0
Malawi,303,14,1987,1980.7,289,36,9,2,11,3,2,1,4,1,3,0
Ivory Coast,298,18,1987,1980.7,280,37,7,7,11,7,5,4,2,3,0,0
Nigeria,289,7,1987,1980.7,282,38,3,3,6,1,3,0,0,1,0,2
Trinidad and Tobago,284,11,1987,1980.7,273,39,1,2,5,6,1,2,0,0,0,0
Uganda,283,7,1987,1980.7,276,40,2,3,4,3,1,1,0,2,1,0
Guinea,247,4,1987,1980.7,243,41,7,1,4,0,4,0,0,1,3,0
Algeria,238,8,1987,1980.7,230,42,4,3,6,2,3,0,0,3,1,0
Democratic Republic of the Congo,238,7,1987,1980.7,231,43,2,4,3,4,1,1,0,2,1,1
New Zealand,233,2,1987,1980.7,231,44,1,1,1,1,1,0,0,0,0,1
Tunisia,227,5,1987,1980.7,222,45,2,4,3,2,0,1,2,2,0,1
Turkey,226,4,1987,1980.7,222,46,3,2,4,0,1,0,1,2,1,0
Greece,219,9,1987,1980.7,210,47,4,5,5,4,2,0,1,2,1,3
Cameroon,218,10,1987,1980.7,208,48,5,2,9,1,4,1,0,1,1,0
Congo,205,4,1987,1980.7,201,49,2,2,2,2,0,0,1,2,1,0
Egypt,203,6,1987,1980.7,197,50,2,3,4,2,1,1,0,0,1,2
Guatemala,195,2,1987,1980.7,193,51,1,1,2,0,1,0,0,1,0,0
Senegal,192,9,1987,1980.7,183,52,4,7,4,5,1,2,1,2,2,3
El Salvador,190,5,1987,1980.7,185,53,4,2,5,0,2,0,2,2,0,0
Mali,182,10,1987,1980.7,172,54,5,7,7,3,3,1,1,4,1,2
Australia,180,3,1987,1980.7,177,55,3,2,2,1,1,0,0,1,2,1
Tanzania,178,3,1987,1980.7,175,56,1,3,1,2,0,0,0,2,1,1
Israel,177,4,1987,1980.7,173,57,5,3,2,2,0,0,3,3,2,0
Bolivia,164,1,1987,1980.7,163,58,2,2,0,1,0,0,2,1,0,1
Colombia,154,9,1987,1980.7,145,59,2,4,4,5,2,2,0,2,0,0
Ecuador,153,6,1987,1980.7,147,60,3,5,3,3,1,0,1,4,1,1
Honduras,146,4,1987,1980.7,142,61,2,1,2,2,1,1,0,0,1,0
Sudan,145,3,1987,1980.7,142,62,2,2,2,1,2,0,0,1,0,1
Iceland,142,5,1987,1980.7,137,63,2,5,2,3,1,2,1,2,0,1
Togo,132,3,1987,1980.7,129,64,3,2,3,0,2,0,0,2,1,0
Zimbabwe,120,9,1987,1980.7,111,65,2,7,1,8,0,1,1,1,1,5
Panama,111,8,1987,1980.7,103,66,3,4,2,6,1,3,1,0,1,1
Jamaica,89,5,1987,1980.7,84,67,1,1,2,3,1,1,0,0,0,0
Madagascar,84,7,1987,1980.7,77,68,3,1,7,0,3,0,0,1,0,0
Luxembourg,80,2,1987,1980.7,78,69,3,4,1,1,0,0,2,4,1,0
Cuba,64,7,1987,1980.7,57,70,1,7,1,6,0,2,0,3,1,2
Sierra Leone,64,7,1987,1980.7,57,71,2,6,2,5,1,3,0,1,1,2
Burkina Faso,63,10,1987,1980.7,53,72,6,4,8,2,3,1,2,3,1,0
Benin,54,3,1987,1980.7,51,73,1,3,1,2,0,0,0,1,1,2
Guyana,53,10,1987,1980.7,43,74,3,2,5,5,1,1,1,0,1,1
Malta,43,5,1987,1980.7,38,75,2,5,1,4,0,0,1,3,1,2
Gabon,41,3,1987,1980.7,38,76,2,4,1,2,1,0,0,1,1,3
Papua New Guinea,41,24,1987,1980.7,17,77,2,2,4,20,1,1,0,1,1,0
Cyprus,39,2,1987,1980.7,37,78,2,6,0,2,0,0,2,5,0,1
Barbados,37,4,1987,1980.7,33,79,3,1,3,1,0,0,1,1,2,0
Guinea-Bissau,36,3,1987,1980.7,33,80,2,3,1,2,0,1,0,0,2,2
Albania,33,1,1987,1980.7,32,81,2,2,0,1,0,0,2,2,0,0
Angola,33,5,1987,1980.7,28,82,4,4,4,1,2,0,0,2,2,2
Venezuela,28,1,1987,1980.7,27,83,1,1,1,0,0,0,1,1,0,0
Mauritania,24,3,1987,1980.7,21,84,1,5,1,2,0,0,1,4,0,1
Central African Republic,18,3,1987,1980.7,15,85,1,3,1,2,0,0,0,3,1,0
American Samoa,0,0,1987,1980.7,0,86,2,1,0,0,0,0,2,1,0,0
Equatorial Guinea,0,0,1987,1980.7,0,87,1,3,0,0,0,0,0,2,1,1
Germany,1624,25,1988,1980.8,1599,1,14,6,18,7,7,1,3,3,4,2
Hungary,1382,12,1988,1980.8,1370,2,6,5,7,5,3,1,1,2,2,2
Sweden,1370,18,1988,1980.8,1352,3,4,6,7,11,2,4,1,0,1,2
England,1154,9,1988,1980.8,1145,4,8,4,7,2,2,1,3,0,3,3
Argentina,1053,14,1987,1980.7,1039,5,6,3,13,1,6,0,0,2,0,1
Argentina,1061,8,1988,1980.8,1053,5,4,3,6,2,1,0,1,2,2,1
Brazil,930,12,1988,1980.8,918,6,1,6,4,8,1,4,0,0,0,2
Austria,925,14,1988,1980.8,911,7,6,4,6,8,2,1,3,2,1,1
Scotland,919,5,1988,1980.8,914,8,1,6,0,5,0,1,0,2,1,3
Denmark,882,12,1988,1980.8,870,9,5,7,7,5,2,1,2,4,1,2
Netherlands,837,14,1988,1980.8,823,10,4,7,4,10,2,4,2,1,0,2
Belgium,778,9,1988,1980.8,769,11,3,3,5,4,2,1,1,1,0,1
France,750,10,1988,1980.8,740,12,5,3,8,2,4,0,0,0,1,3
Italy,738,16,1988,1980.8,722,13,7,3,12,4,6,1,1,1,0,1
Czech Republic,730,15,1988,1980.8,715,14,6,5,9,6,3,3,1,1,2,1
Uruguay,724,13,1988,1980.8,711,15,3,5,8,5,3,1,0,3,0,1
Poland,722,16,1988,1980.8,706,16,3,6,6,10,2,3,0,2,1,1
South Korea,696,21,1988,1980.8,675,17,6,6,12,9,4,4,0,1,2,1
Norway,673,9,1988,1980.8,664,18,4,4,3,6,0,1,1,3,3,0
Switzerland,633,11,1988,1980.8,622,19,2,6,1,10,0,3,1,3,1,0
Russia,563,27,1988,1980.8,536,20,4,14,6,21,3,7,1,3,0,4
Spain,533,14,1988,1980.8,519,21,7,5,9,5,2,1,2,3,3,1
Wales,512,7,1988,1980.8,505,22,1,4,2,5,0,2,0,2,1,0
Bulgaria,506,20,1988,1980.8,486,23,3,9,4,16,1,4,1,2,1,3
Paraguay,493,13,1988,1980.8,480,24,2,5,5,8,2,3,0,1,0,1
Mexico,470,13,1988,1980.8,457,25,2,1,12,1,2,1,0,0,0,0
Romania,469,19,1988,1980.8,450,26,3,6,9,10,3,2,0,2,0,2
Chile,462,15,1988,1980.8,447,27,5,7,6,9,2,2,1,3,2,2
Finland,457,9,1988,1980.8,448,28,6,5,5,4,1,1,3,1,2,3
Zambia,448,23,1988,1980.8,425,29,5,8,16,7,3,3,1,3,1,2
Ghana,447,5,1988,1980.8,442,30,3,6,1,4,1,1,1,3,1,2
Northern Ireland,413,6,1988,1980.8,407,31,4,3,4,2,1,0,0,3,3,0
Indonesia,408,8,1988,1980.8,400,32,8,2,5,3,2,0,4,0,2,2
China,395,20,1988,1980.8,375,33,7,5,13,7,3,2,1,1,3,2
Thailand,339,11,1988,1980.8,328,34,4,6,8,3,2,0,0,3,2,3
Peru,333,2,1988,1980.8,331,35,3,2,2,0,0,0,2,2,1,0
Kenya,322,2,1988,1980.8,320,36,4,3,2,0,1,0,2,2,1,1
Portugal,322,1,1988,1980.8,321,37,1,1,1,0,1,0,0,0,0,1
Malawi,321,18,1988,1980.8,303,38,9,5,13,5,5,1,1,3,3,1
Ireland,318,11,1988,1980.8,307,39,5,4,10,1,3,1,1,1,1,2
Ivory Coast,302,4,1988,1980.8,298,40,3,2,3,1,1,0,0,0,2,2
Trinidad and Tobago,298,14,1988,1980.8,284,41,3,5,2,12,1,3,1,0,1,2
Costa Rica,294,9,1988,1980.8,285,42,2,6,3,6,1,3,0,2,1,1
Iraq,288,17,1988,1980.8,271,43,7,6,8,9,3,4,0,0,4,2
Uganda,286,3,1988,1980.8,283,44,3,2,1,2,1,0,1,2,1,0
Singapore,277,3,1988,1980.8,274,45,1,1,0,3,0,1,1,0,0,0
Algeria,258,20,1988,1980.8,238,46,9,4,17,3,4,0,0,2,5,2
Guinea,258,11,1988,1980.8,247,47,6,4,9,2,4,1,0,2,2,1
New Zealand,244,11,1988,1980.8,233,48,2,6,5,6,1,2,1,3,0,1
Curaçao,243,6,1988,1980.8,237,49,5,2,5,1,2,1,1,1,2,0
Tunisia,243,16,1988,1980.8,227,50,2,13,10,6,2,0,0,8,0,5
Democratic Republic of the Congo,241,3,1988,1980.8,238,51,2,3,1,2,1,0,0,1,1,2
Turkey,235,9,1988,1980.8,226,52,3,2,7,2,2,0,0,2,1,0
Greece,234,15,1988,1980.8,219,53,5,7,9,6,2,3,1,3,2,1
Cameroon,226,8,1988,1980.8,218,54,8,1,7,1,4,1,1,0,3,0
Japan,224,8,1988,1980.8,216,55,5,8,5,3,1,1,2,5,2,2
Egypt,222,19,1988,1980.8,203,56,9,9,9,10,4,3,1,1,4,5
Morocco,221,15,1988,1980.8,206,57,9,2,11,4,4,1,1,1,4,0
Kuwait,219,18,1988,1980.8,201,58,13,10,8,10,2,3,5,3,6,4
Congo,212,7,1988,1980.8,205,59,1,5,2,5,1,2,0,3,0,0
Guatemala,206,11,1988,1980.8,195,60,6,7,5,6,3,2,2,3,1,2
Senegal,205,13,1988,1980.8,192,61,2,5,4,9,1,3,0,0,1,2
El Salvador,198,8,1988,1980.8,190,62,7,2,7,1,2,1,1,1,4,0
Mali,198,16,1988,1980.8,182,63,4,10,7,9,2,4,0,5,2,1
Australia,196,16,1988,1980.8,180,64,6,2,14,2,4,1,2,1,0,0
Hong Kong,184,2,1988,1980.8,182,65,2,4,0,2,0,1,2,2,0,1
Israel,183,6,1988,1980.8,177,66,6,1,6,0,1,0,3,1,2,0
Saudi Arabia,172,24,1988,1980.8,148,67,16,12,14,10,4,4,3,5,9,3
Colombia,163,9,1988,1980.8,154,68,2,3,5,4,2,1,0,0,0,2
Ecuador,161,8,1988,1980.8,153,69,2,7,2,6,0,3,2,1,0,3
Honduras,149,3,1988,1980.8,146,70,6,4,2,1,0,0,3,1,3,3
Iceland,147,5,1988,1980.8,142,71,4,4,4,1,1,0,2,3,1,1
Sudan,146,1,1988,1980.8,145,72,1,1,1,0,0,0,1,0,0,1
Libya,143,4,1988,1980.8,139,73,2,1,4,0,2,0,0,1,0,0
Iran,138,9,1988,1980.8,129,74,2,7,3,6,2,2,0,2,0,3
Panama,112,1,1988,1980.8,111,75,1,1,0,1,0,0,1,0,0,1
USA,112,9,1988,1980.8,103,76,8,3,8,1,2,1,4,1,2,1
Canada,110,14,1988,1980.8,96,77,7,7,5,9,2,3,4,2,1,2
United Arab Emirates,109,33,1988,1980.8,76,78,18,7,27,6,10,2,3,4,5,1
Qatar,108,20,1988,1980.8,88,79,8,7,12,8,3,4,4,2,1,1
Bahrain,101,9,1988,1980.8,92,80,7,9,5,4,2,2,4,2,1,5
Guadeloupe,100,4,1988,1980.8,96,81,4,2,3,1,1,0,2,1,1,1
New Caledonia,94,6,1988,1980.8,88,82,2,2,6,0,1,0,1,2,0,0
Jamaica,93,4,1988,1980.8,89,83,4,2,1,3,1,1,1,1,2,0
Syria,87,13,1988,1980.8,74,84,5,9,4,9,2,4,2,2,1,3
Luxembourg,81,1,1988,1980.8,80,85,3,1,1,0,0,0,3,1,0,0
Burkina Faso,77,14,1988,1980.8,63,86,8,2,14,0,8,0,0,2,0,0
Gambia,67,4,1988,1980.8,63,87,5,1,3,1,1,0,3,1,1,0
Cuba,65,1,1988,1980.8,64,88,1,2,0,1,0,0,1,0,0,2
Fiji,63,20,1988,1980.8,43,89,6,3,15,5,5,1,0,1,1,1
Benin,56,2,1988,1980.8,54,90,4,1,2,0,0,0,3,1,1,0
Malta,54,11,1988,1980.8,43,91,6,4,10,1,2,1,1,3,3,0
Guyana,53,0,1988,1980.8,53,92,1,1,0,0,0,0,1,1,0,0
Gabon,51,10,1988,1980.8,41,93,1,7,3,7,1,2,0,3,0,2
Liberia,50,3,1988,1980.8,47,94,5,2,3,0,1,0,2,1,2,1
Angola,44,11,1988,1980.8,33,95,3,6,5,6,1,2,1,1,1,3
Cyprus,41,2,1988,1980.8,39,96,3,1,1,1,0,0,2,0,1,1
Mozambique,41,3,1988,1980.8,38,97,2,2,2,1,0,0,1,1,1,1
Jordan,40,11,1988,1980.8,29,98,9,5,7,4,4,0,4,2,1,3
Oman,36,6,1988,1980.8,30,99,5,5,4,2,1,0,3,4,1,1
Albania,34,1,1988,1980.8,33,100,2,2,1,0,0,0,1,2,1,0
Dominica,33,1,1988,1980.8,32,101,1,1,0,1,0,0,0,1,1,0
Lebanon,30,2,1988,1980.8,28,102,2,2,2,0,1,0,0,1,1,1
Bangladesh,28,1,1988,1980.8,27,103,1,4,0,1,0,0,0,2,1,2
Antigua and Barbuda,22,6,1988,1980.8,16,104,4,3,3,3,1,0,1,1,2,2
Puerto Rico,8,1,1988,1980.8,7,105,1,1,1,0,0,0,1,1,0,0
Yemen,8,5,1988,1980.8,3,106,3,2,4,1,1,0,0,1,2,1
Seychelles,5,1,1988,1980.8,4,107,1,1,1,0,0,0,0,1,1,0
Equatorial Guinea,1,1,1988,1980.8,0,108,2,1,0,1,0,0,1,1,1,0
Germany,1654,30,1989,1980.9,1624,1,7,10,13,17,3,4,1,3,3,3
Hungary,1391,9,1989,1980.9,1382,2,5,4,7,2,1,1,0,3,4,0
Sweden,1385,15,1989,1980.9,1370,3,5,4,9,6,3,3,1,1,1,0
England,1169,15,1989,1980.9,1154,4,4,6,8,7,2,3,0,0,2,3
Argentina,1066,5,1989,1980.9,1061,5,4,7,1,4,1,1,1,2,2,4
Brazil,969,39,1989,1980.9,930,6,15,7,31,8,12,3,1,2,2,2
Austria,935,10,1989,1980.9,925,7,5,5,6,4,2,1,2,2,1,2
Scotland,929,10,1989,1980.9,919,8,5,2,7,3,3,1,1,1,1,0
Denmark,912,30,1989,1980.9,882,9,7,7,23,7,5,2,0,3,2,2
Netherlands,850,13,1989,1980.9,837,10,5,3,8,5,2,3,1,0,2,0
Belgium,797,19,1989,1980.9,778,11,4,4,9,10,3,2,0,0,1,2
France,760,10,1989,1980.9,750,12,2,4,5,5,2,1,0,1,0,2
Italy,750,12,1989,1980.9,738,13,7,3,11,1,4,1,1,1,2,1
Uruguay,750,26,1989,1980.9,724,14,9,9,13,13,5,4,2,2,2,3
Czech Republic,745,15,1989,1980.9,730,15,4,5,11,4,4,2,0,1,0,2
Poland,736,14,1989,1980.9,722,16,5,7,6,8,2,3,1,4,2,0
South Korea,730,34,1989,1980.9,696,17,7,8,16,18,4,6,1,1,2,1
Norway,686,13,1989,1980.9,673,18,5,3,8,5,2,0,1,1,2,2
Switzerland,641,8,1989,1980.9,633,19,5,4,6,2,2,0,2,4,1,0
Russia,574,11,1989,1980.9,563,20,3,6,6,5,2,2,0,2,1,2
Spain,550,17,1989,1980.9,533,21,4,4,11,6,4,2,0,1,0,1
Paraguay,529,36,1989,1980.9,493,22,8,16,15,21,5,7,1,6,2,3
Wales,517,5,1989,1980.9,512,23,3,3,1,4,0,0,2,2,1,1
Bulgaria,513,7,1989,1980.9,506,24,4,4,6,1,1,0,3,3,0,1
Chile,489,27,1989,1980.9,462,25,8,14,13,14,4,6,1,6,3,2
Mexico,481,11,1989,1980.9,470,26,2,2,7,4,2,2,0,0,0,0
Romania,475,6,1989,1980.9,469,27,3,5,5,1,3,0,0,3,0,2
Zambia,465,17,1989,1980.9,448,28,4,12,10,7,4,2,0,7,0,3
Finland,463,6,1989,1980.9,457,29,2,10,1,5,1,1,1,6,0,3
Ghana,450,3,1989,1980.9,447,30,2,2,2,1,1,0,0,1,1,1
Malaysia,419,11,1989,1980.9,408,31,4,5,6,5,3,1,1,3,0,1
Northern Ireland,416,3,1989,1980.9,413,32,3,2,1,2,0,1,3,1,0,0
Indonesia,415,7,1989,1980.9,408,33,3,4,4,3,1,1,1,2,1,1
China,414,19,1989,1980.9,395,34,6,9,9,10,4,2,2,5,0,2
Peru,349,16,1989,1980.9,333,35,5,14,5,11,1,1,2,9,2,4
Thailand,347,8,1989,1980.9,339,36,6,3,7,1,4,0,2,3,0,0
Trinidad and Tobago,341,43,1989,1980.9,298,37,13,11,26,17,6,5,3,3,4,3
Portugal,340,18,1989,1980.9,322,38,5,6,10,8,2,3,0,3,3,0
Malawi,335,14,1989,1980.9,321,39,10,8,9,5,3,2,2,4,5,2
Kenya,332,10,1989,1980.9,322,40,10,4,10,0,6,0,2,3,2,1
Ireland,329,11,1989,1980.9,318,41,6,2,9,2,4,1,0,0,2,1
Ivory Coast,320,18,1989,1980.9,302,42,6,4,14,4,4,1,0,1,2,2
Costa Rica,307,13,1989,1980.9,294,43,6,4,8,5,4,1,1,2,1,1
Uganda,305,19,1989,1980.9,286,44,2,7,4,15,1,2,0,1,1,4
Iraq,303,15,1989,1980.9,288,45,5,6,11,4,3,2,0,2,2,2
Nigeria,301,12,1989,1980.9,289,46,4,5,7,5,4,0,0,2,0,3
Singapore,290,13,1989,1980.9,277,47,5,2,13,0,2,0,2,2,1,0
Algeria,271,13,1989,1980.9,258,48,8,9,10,3,4,2,0,4,4,3
Guinea,266,8,1989,1980.9,258,49,4,6,6,2,2,1,0,4,2,1
Democratic Republic of the Congo,252,11,1989,1980.9,241,50,4,9,4,7,2,1,0,4,2,4
Tunisia,251,8,1989,1980.9,243,51,8,7,7,1,4,0,2,6,2,1
New Zealand,249,5,1989,1980.9,244,52,2,2,4,1,1,0,0,2,1,0
Greece,247,13,1989,1980.9,234,53,7,6,10,3,3,0,3,3,1,3
Egypt,246,24,1989,1980.9,222,54,10,10,20,4,9,2,1,2,0,6
Turkey,242,7,1989,1980.9,235,55,2,4,3,4,1,2,1,2,0,0
Cameroon,239,13,1989,1980.9,226,56,4,6,6,7,3,4,0,1,1,1
Kuwait,238,19,1989,1980.9,219,57,10,3,18,1,6,1,1,2,3,0
Japan,235,11,1989,1980.9,224,58,4,5,9,2,2,0,0,2,2,3
Morocco,228,7,1989,1980.9,221,59,5,5,4,3,2,0,0,2,3,3
Senegal,219,14,1989,1980.9,205,60,6,4,10,4,4,1,0,1,2,2
Guatemala,218,12,1989,1980.9,206,61,8,4,6,6,2,1,5,3,1,0
Mali,211,13,1989,1980.9,198,62,7,2,11,2,3,0,0,1,4,1
Australia,202,6,1989,1980.9,196,63,2,2,5,1,1,0,0,1,1,1
El Salvador,202,4,1989,1980.9,198,64,6,5,3,1,0,0,5,3,1,2
Ethiopia,196,6,1989,1980.9,190,65,5,1,5,1,2,0,1,1,2,0
Israel,193,10,1989,1980.9,183,66,5,4,5,5,1,1,1,1,3,2
Hong Kong,189,5,1989,1980.9,184,67,4,2,3,2,1,0,0,1,3,1
Colombia,182,19,1989,1980.9,163,68,8,8,9,10,6,3,1,1,1,4
Saudi Arabia,181,9,1989,1980.9,172,69,4,4,6,3,2,1,1,1,1,2
Tanzania,180,2,1989,1980.9,178,70,2,1,1,1,0,0,2,1,0,0
Bolivia,174,10,1989,1980.9,164,71,6,8,7,3,3,1,2,5,1,2
Ecuador,173,12,1989,1980.9,161,72,7,7,8,4,2,1,1,5,4,1
Martinique,164,1,1989,1980.9,163,73,2,1,0,1,0,0,1,1,1,0
Iran,155,17,1989,1980.9,138,74,6,5,11,6,3,2,0,2,3,1
Iceland,151,4,1989,1980.9,147,75,3,2,2,2,1,0,1,1,1,1
Sudan,147,1,1989,1980.9,146,76,1,1,1,0,1,0,0,1,0,0
Zimbabwe,132,12,1989,1980.9,120,77,5,6,3,9,1,2,1,3,3,1
United Arab Emirates,125,16,1989,1980.9,109,78,4,4,8,8,2,2,0,1,2,1
USA,124,12,1989,1980.9,112,79,8,4,10,2,4,2,2,1,2,1
Qatar,122,14,1989,1980.9,108,80,7,7,9,5,5,0,1,1,1,6
Mauritius,113,1,1989,1980.9,112,81,1,1,1,0,0,0,1,1,0,0
Canada,111,1,1989,1980.9,110,82,1,3,0,1,0,1,1,2,0,0
Guadeloupe,105,5,1989,1980.9,100,83,3,2,2,3,1,1,1,1,1,0
New Caledonia,103,9,1989,1980.9,94,84,3,1,9,0,3,0,0,1,0,0
Jamaica,97,4,1989,1980.9,93,85,3,4,2,2,0,0,2,1,1,3
Syria,94,7,1989,1980.9,87,86,2,2,2,5,1,1,0,1,1,0
Luxembourg,83,2,1989,1980.9,81,87,2,3,0,2,0,0,2,2,0,1
Gabon,64,13,1989,1980.9,51,88,7,7,8,5,5,2,1,5,1,0
Liberia,57,7,1989,1980.9,50,89,6,3,7,0,4,0,0,2,2,1
Malta,57,3,1989,1980.9,54,90,9,4,2,1,0,0,8,2,1,2
Angola,53,9,1989,1980.9,44,91,5,6,6,3,1,1,2,4,2,1
Aruba,49,1,1989,1980.9,48,92,3,2,1,0,0,0,2,2,1,0
Papua New Guinea,46,5,1989,1980.9,41,93,2,2,3,2,1,0,0,2,1,0
Cyprus,45,4,1989,1980.9,41,94,2,3,2,2,0,0,1,3,1,0
Jordan,45,5,1989,1980.9,40,95,3,3,3,2,1,1,1,2,1,0
Mozambique,45,4,1989,1980.9,41,96,1,5,0,4,0,2,1,2,0,1
Guinea-Bissau,40,4,1989,1980.9,36,97,1,2,0,4,0,1,0,1,1,0
Oman,38,2,1989,1980.9,36,98,3,3,1,1,0,0,1,3,2,0
Pakistan,38,1,1989,1980.9,37,99,2,2,1,0,0,0,2,2,0,0
Venezuela,38,10,1989,1980.9,28,100,6,6,7,3,1,0,4,5,1,1
Albania,37,3,1989,1980.9,34,101,3,2,2,1,0,0,2,2,1,0
Grenada,36,5,1989,1980.9,31,102,3,2,4,1,2,0,1,0,0,2
Dominica,33,0,1989,1980.9,33,103,2,2,0,0,0,0,1,0,1,2
Bangladesh,32,4,1989,1980.9,28,104,3,3,4,0,1,0,2,3,0,0
Lebanon,30,0,1989,1980.9,30,105,1,1,0,0,0,0,1,1,0,0
Mauritania,26,2,1989,1980.9,24,106,1,1,1,1,0,0,1,1,0,0
Antigua and Barbuda,24,2,1989,1980.9,22,107,1,1,1,1,1,1,0,0,0,0
Central African Republic,19,1,1989,1980.9,18,108,1,1,1,0,0,0,0,1,1,0
Cape Verde,18,6,1989,1980.9,12,109,4,1,5,1,2,0,2,0,0,1
Nepal,17,0,1989,1980.9,17,110,1,5,0,0,0,0,1,5,0,0
Chad,13,1,1989,1980.9,12,111,3,1,0,1,0,0,2,0,1,1
St. Kitts and Nevis,10,5,1989,1980.9,5,112,1,2,0,5,0,1,1,1,0,0
Swaziland,10,1,1989,1980.9,9,113,1,1,0,1,0,0,1,0,0,1
Yemen,8,0,1989,1980.9,8,114,2,2,0,0,0,0,2,2,0,0
Åland Islands,4,4,1989,1980.9,0,115,1,1,3,1,1,0,0,1,0,0
St. Lucia,4,1,1989,1980.9,3,116,1,1,0,1,0,0,0,0,1,1
Solomon Islands,2,2,1989,1980.9,0,117,1,3,2,0,1,0,0,1,0,2
Germany,1695,41,1990,1990,1654,1,12,9,25,16,9,5,0,2,3,2
Hungary,1409,18,1990,1990,1391,2,7,3,18,0,5,0,1,2,1,1
Sweden,1407,22,1990,1990,1385,3,7,6,15,7,3,2,4,2,0,2
England,1189,20,1990,1990,1169,4,10,5,13,7,7,1,1,1,2,3
Argentina,1075,9,1990,1990,1066,5,3,8,3,6,1,2,1,3,1,3
Brazil,978,9,1990,1990,969,6,7,3,9,0,4,0,1,2,2,1
Austria,948,13,1990,1990,935,7,7,4,10,3,3,1,2,2,2,1
Scotland,941,12,1990,1990,929,8,6,5,7,5,3,2,2,2,1,1
Denmark,923,11,1990,1990,912,9,3,7,6,5,3,2,0,2,0,3
Netherlands,864,14,1990,1990,850,10,2,8,1,13,0,1,0,5,2,2
Belgium,810,13,1990,1990,797,11,8,3,12,1,3,0,2,3,3,0
France,774,14,1990,1990,760,12,4,4,7,7,3,4,0,0,1,0
Italy,767,17,1990,1990,750,13,10,4,11,6,7,2,0,0,3,2
Czech Republic,763,18,1990,1990,745,14,4,9,8,10,3,2,1,6,0,1
Uruguay,762,12,1990,1990,750,15,1,9,0,12,0,4,0,4,1,1
Poland,756,20,1990,1990,736,16,2,13,6,14,1,5,1,4,0,4
South Korea,741,11,1990,1990,730,17,5,7,5,6,2,3,3,1,0,3
Norway,707,21,1990,1990,686,18,4,6,8,13,1,4,2,1,1,1
Switzerland,656,15,1990,1990,641,19,5,4,7,8,3,2,1,2,1,0
Russia,595,21,1990,1990,574,20,4,11,5,16,2,5,2,3,0,3
Spain,574,24,1990,1990,550,21,5,4,17,7,4,2,1,1,0,1
Wales,524,7,1990,1990,517,22,2,4,4,3,2,1,0,3,0,0
Bulgaria,518,5,1990,1990,513,23,1,4,1,4,0,1,0,3,1,0
Romania,501,26,1990,1990,475,24,4,12,9,17,3,4,1,4,0,4
Mexico,488,7,1990,1990,481,25,4,2,6,1,3,0,0,2,1,0
Zambia,478,13,1990,1990,465,26,6,3,11,2,4,2,0,1,2,0
Finland,471,8,1990,1990,463,27,2,7,1,7,0,2,0,2,2,3
Indonesia,424,9,1990,1990,415,28,3,1,8,1,1,0,2,0,0,1
Northern Ireland,420,4,1990,1990,416,29,3,1,4,0,1,0,1,0,1,1
Malaysia,419,0,1990,1990,419,30,1,1,0,0,0,0,1,1,0,0
China,417,3,1990,1990,414,31,3,2,2,1,1,0,1,2,1,0
Malawi,345,10,1990,1990,335,32,10,1,8,2,4,0,1,0,5,1
Ireland,344,15,1990,1990,329,33,9,4,11,4,4,1,0,1,5,2
Portugal,343,3,1990,1990,340,34,3,1,3,0,2,0,0,0,1,1
Trinidad and Tobago,341,0,1990,1990,341,35,3,1,0,0,0,0,1,1,2,0
Kenya,340,8,1990,1990,332,36,2,6,3,5,0,1,1,4,1,1
Ivory Coast,328,8,1990,1990,320,37,3,5,6,2,3,1,0,4,0,0
Uganda,319,14,1990,1990,305,38,2,6,6,8,2,1,0,1,0,4
Costa Rica,314,7,1990,1990,307,39,4,5,2,5,1,2,3,3,0,0
Nigeria,310,9,1990,1990,301,40,5,3,7,2,4,1,0,2,1,0
Iraq,309,6,1990,1990,303,41,1,4,0,6,0,2,0,0,1,2
Singapore,293,3,1990,1990,290,42,1,1,3,0,1,0,0,1,0,0
Greece,263,16,1990,1990,247,43,6,1,16,0,5,0,1,0,0,1
Cameroon,259,20,1990,1990,239,44,9,9,10,10,4,3,4,3,1,3
Egypt,259,13,1990,1990,246,45,6,13,4,9,1,3,1,8,4,2
Tunisia,258,7,1990,1990,251,46,5,1,5,2,1,1,2,0,2,0
Democratic Republic of the Congo,255,3,1990,1990,252,47,1,5,2,1,1,0,0,3,0,2
Curaçao,249,6,1990,1990,243,48,1,3,1,5,0,1,0,0,1,2
Turkey,243,1,1990,1990,242,49,2,3,0,1,0,0,1,3,1,0
Morocco,236,8,1990,1990,228,50,3,2,8,0,3,0,0,1,0,1
Japan,235,0,1990,1990,235,51,1,1,0,0,0,0,1,1,0,0
Congo,229,17,1990,1990,212,52,6,3,15,2,6,1,0,2,0,0
Senegal,224,5,1990,1990,219,53,2,6,0,5,0,2,1,2,1,2
Mali,214,3,1990,1990,211,54,2,4,3,0,1,0,0,1,1,3
Israel,199,6,1990,1990,193,55,3,1,5,1,1,0,2,1,0,0
Ethiopia,196,0,1990,1990,196,56,1,1,0,0,0,0,1,1,0,0
Colombia,192,10,1990,1990,182,57,3,8,2,8,1,2,1,3,1,3
Tanzania,188,8,1990,1990,180,58,3,9,4,4,1,1,0,4,2,4
Suriname,181,7,1990,1990,174,59,1,3,5,2,1,0,0,2,0,1
Martinique,168,4,1990,1990,164,60,1,3,0,4,0,1,0,1,1,1
Iceland,165,14,1990,1990,151,61,2,6,3,11,1,3,1,3,0,0
Zimbabwe,154,22,1990,1990,132,62,1,9,4,18,0,4,0,4,1,1
USA,153,29,1990,1990,124,63,11,11,16,13,5,3,4,7,2,1
Sudan,151,4,1990,1990,147,64,2,1,2,2,0,1,1,0,1,0
United Arab Emirates,136,11,1990,1990,125,65,8,7,8,3,2,0,3,5,3,2
Togo,134,2,1990,1990,132,66,3,1,1,1,0,0,1,0,2,1
Qatar,126,4,1990,1990,122,67,2,2,0,4,0,1,0,1,2,0
New Caledonia,108,5,1990,1990,103,68,3,1,5,0,2,0,0,1,1,0
Guadeloupe,107,2,1990,1990,105,69,2,2,1,1,1,0,0,2,1,0
Jamaica,104,7,1990,1990,97,70,4,3,5,2,3,1,1,0,0,2
Bahrain,102,1,1990,1990,101,71,3,2,1,0,1,0,1,1,1,1
Burkina Faso,79,2,1990,1990,77,72,1,2,1,1,1,0,0,1,0,1
Gambia,69,2,1990,1990,67,73,3,1,2,0,1,0,1,1,1,0
Gabon,68,4,1990,1990,64,74,3,4,1,3,1,1,1,3,1,0
Angola,65,12,1990,1990,53,75,4,3,8,4,3,1,1,1,0,1
Fiji,65,2,1990,1990,63,76,2,2,1,1,1,0,0,0,1,2
Malta,61,4,1990,1990,57,77,6,2,4,0,0,0,4,2,2,0
Mozambique,59,14,1990,1990,45,78,6,3,12,2,4,0,2,2,0,1
Liberia,57,0,1990,1990,57,79,1,1,0,0,0,0,1,1,0,0
Guyana,54,1,1990,1990,53,80,2,1,1,0,0,0,0,1,2,0
Barbados,53,16,1990,1990,37,81,6,4,14,2,4,1,0,2,2,1
Cyprus,47,2,1990,1990,45,82,2,1,0,2,0,0,2,1,0,0
Oman,42,4,1990,1990,38,83,2,2,3,1,0,0,1,0,1,2
Grenada,41,5,1990,1990,36,84,2,3,4,1,1,0,0,1,1,2
Niger,41,0,1990,1990,41,85,1,1,0,0,0,0,1,1,0,0
Albania,37,0,1990,1990,37,86,1,3,0,0,0,0,1,3,0,0
Bermuda,31,11,1990,1990,20,87,6,1,9,2,2,1,2,0,2,0
Mauritania,29,3,1990,1990,26,88,1,3,2,1,1,0,0,3,0,0
Antigua and Barbuda,27,3,1990,1990,24,89,1,4,0,3,0,0,1,3,0,1
Swaziland,20,10,1990,1990,10,90,4,3,4,6,1,0,1,2,2,1
Lesotho,18,2,1990,1990,16,91,1,2,1,1,0,0,1,2,0,0
Chad,17,4,1990,1990,13,92,3,2,3,1,2,0,1,2,0,0
St. Kitts and Nevis,15,5,1990,1990,10,93,2,1,5,0,2,0,0,1,0,0
Botswana,12,6,1990,1990,6,94,6,1,5,1,1,0,2,1,3,0
Faroe Islands,11,4,1990,1990,7,95,2,1,3,1,1,0,1,1,0,0
St. Lucia,6,2,1990,1990,4,96,1,2,0,2,0,1,1,1,0,0
Solomon Islands,5,3,1990,1990,2,97,1,3,1,2,1,0,0,1,0,2
St. Martin,5,5,1990,1990,0,98,2,1,5,0,2,0,0,1,0,0
San Marino,0,0,1990,1990,0,99,1,1,0,0,0,0,1,1,0,0
Germany,1708,13,1991,1990.1,1695,1,4,3,11,2,4,2,0,1,0,0
Hungary,1427,18,1991,1990.1,1409,2,6,8,6,12,1,3,3,3,2,2
Sweden,1426,19,1991,1990.1,1407,3,4,4,14,5,2,1,1,2,1,1
England,1208,19,1991,1990.1,1189,4,6,6,9,10,3,5,1,0,2,1
Argentina,1101,26,1991,1990.1,1075,5,9,5,21,5,6,2,0,0,3,3
Brazil,1000,22,1991,1990.1,978,6,8,5,13,9,4,2,1,2,3,1
Austria,954,6,1991,1990.1,948,7,3,4,3,3,1,0,1,3,1,1
Scotland,950,9,1991,1990.1,941,8,3,3,5,4,1,1,1,1,1,1
Denmark,935,12,1991,1990.1,923,9,4,4,5,7,2,2,1,1,1,1
Netherlands,872,8,1991,1990.1,864,10,4,2,5,3,3,1,0,0,1,1
Belgium,818,8,1991,1990.1,810,11,3,4,4,4,1,2,1,1,1,1
France,794,20,1991,1990.1,774,12,3,3,11,9,3,3,0,0,0,0
Czech Republic,782,19,1991,1990.1,763,13,4,7,8,11,2,5,1,2,1,0
Italy,778,11,1991,1990.1,767,14,5,4,7,4,2,1,0,2,3,1
Uruguay,773,11,1991,1990.1,762,15,2,10,2,9,1,2,0,4,1,4
Poland,771,15,1991,1990.1,756,16,7,7,11,4,2,1,1,3,4,3
South Korea,748,7,1991,1990.1,741,17,5,1,6,1,2,1,0,0,3,0
Norway,717,10,1991,1990.1,707,18,6,3,9,1,3,0,3,0,0,3
Switzerland,682,26,1991,1990.1,656,19,4,6,12,14,2,4,0,1,2,1
Russia,622,27,1991,1990.1,595,20,4,11,10,17,2,6,0,2,2,3
Spain,583,9,1991,1990.1,574,21,6,2,8,1,2,0,3,2,1,0
Paraguay,538,9,1991,1990.1,529,22,3,4,6,3,2,1,0,2,1,1
Bulgaria,532,14,1991,1990.1,518,23,5,4,9,5,2,1,1,1,2,2
Wales,530,6,1991,1990.1,524,24,5,3,4,2,4,0,1,1,0,2
Romania,511,10,1991,1990.1,501,25,3,7,2,8,2,2,1,2,0,3
Mexico,509,21,1991,1990.1,488,26,8,7,12,9,4,2,1,1,3,4
Chile,508,19,1991,1990.1,489,27,9,4,16,3,5,0,2,3,2,1
Zambia,492,14,1991,1990.1,478,28,1,10,2,12,1,5,0,4,0,1
Finland,476,5,1991,1990.1,471,29,3,4,4,1,1,0,0,3,2,1
Ghana,463,13,1991,1990.1,450,30,4,5,9,4,3,2,1,0,0,3
Northern Ireland,432,12,1991,1990.1,420,31,3,2,6,6,2,1,0,1,1,0
Indonesia,424,0,1991,1990.1,424,32,1,3,0,0,0,0,1,3,0,0
Malaysia,421,2,1991,1990.1,419,33,1,1,2,0,0,0,1,1,0,0
Peru,361,12,1991,1990.1,349,34,3,5,6,6,2,0,1,3,0,2
Ireland,358,14,1991,1990.1,344,35,2,6,1,13,0,3,0,0,2,3
Portugal,356,13,1991,1990.1,343,36,4,5,8,5,3,1,0,2,1,2
Trinidad and Tobago,356,15,1991,1990.1,341,37,2,6,2,13,1,3,1,3,0,0
Malawi,353,8,1991,1990.1,345,38,8,3,7,1,2,0,2,3,4,0
Ivory Coast,352,24,1991,1990.1,328,39,9,5,17,7,8,1,0,2,1,2
Kenya,352,12,1991,1990.1,340,40,4,7,2,10,2,3,2,1,0,3
Uganda,336,17,1991,1990.1,319,41,7,5,15,2,4,0,3,4,0,1
Nigeria,335,25,1991,1990.1,310,42,6,6,22,3,5,1,0,3,1,2
Costa Rica,331,17,1991,1990.1,314,43,7,5,13,4,4,0,1,4,2,1
Egypt,291,32,1991,1990.1,259,44,12,3,30,2,6,0,2,1,4,2
Algeria,283,12,1991,1990.1,271,45,5,3,8,4,3,1,0,0,2,2
Tunisia,277,19,1991,1990.1,258,46,6,7,12,7,2,2,0,2,4,3
Greece,273,10,1991,1990.1,263,47,5,5,7,3,2,0,2,1,1,4
Cameroon,271,12,1991,1990.1,259,48,7,6,6,6,6,1,1,2,0,3
Guinea,269,3,1991,1990.1,266,49,4,5,2,1,1,1,2,1,1,3
Democratic Republic of the Congo,258,3,1991,1990.1,255,50,2,4,3,0,2,0,0,1,0,3
New Zealand,250,1,1991,1990.1,249,51,3,1,0,1,0,0,3,1,0,0
Morocco,247,11,1991,1990.1,236,52,4,4,7,4,2,1,0,2,2,1
Turkey,247,4,1991,1990.1,243,53,3,6,2,2,0,0,2,3,1,3
Senegal,236,12,1991,1990.1,224,54,7,4,8,4,3,1,1,3,3,0
Congo,234,5,1991,1990.1,229,55,3,1,3,2,1,0,1,0,1,1
Mali,228,14,1991,1990.1,214,56,7,8,11,3,2,1,1,6,4,1
Guatemala,219,1,1991,1990.1,218,57,2,4,0,1,0,1,0,3,2,0
El Salvador,208,6,1991,1990.1,202,58,1,4,1,5,0,1,0,2,1,1
Australia,205,3,1991,1990.1,202,59,4,2,2,1,1,1,3,0,0,1
Colombia,202,10,1991,1990.1,192,60,3,8,3,7,1,2,2,2,0,4
Tanzania,194,6,1991,1990.1,188,61,3,4,3,3,1,0,1,3,1,1
Ecuador,185,12,1991,1990.1,173,62,3,5,5,7,1,2,0,3,2,0
Iceland,178,13,1991,1990.1,165,63,4,5,7,6,2,1,1,3,1,1
Bolivia,176,2,1991,1990.1,174,64,5,1,2,0,0,0,3,0,2,1
Martinique,175,7,1991,1990.1,168,65,3,2,3,4,1,1,1,0,1,1
USA,174,21,1991,1990.1,153,66,13,3,18,3,7,1,2,1,4,1
Zimbabwe,168,14,1991,1990.1,154,67,2,6,6,8,1,2,0,3,1,1
Honduras,166,17,1991,1990.1,149,68,3,7,7,10,3,2,0,2,0,3
Sudan,158,7,1991,1990.1,151,69,4,4,5,2,1,1,1,3,2,0
Estonia,157,1,1991,1990.1,156,70,1,1,0,1,0,0,1,1,0,0
Togo,137,3,1991,1990.1,134,71,3,1,3,0,2,0,0,1,1,0
Jamaica,125,21,1991,1990.1,104,72,8,3,19,2,6,0,2,2,0,1
New Caledonia,121,13,1991,1990.1,108,73,2,2,4,9,1,1,1,1,0,0
Canada,117,6,1991,1990.1,111,74,3,2,3,3,0,1,3,1,0,0
Mauritius,116,3,1991,1990.1,113,75,2,2,3,0,1,0,1,2,0,0
Panama,114,2,1991,1990.1,112,76,1,1,2,0,1,0,0,1,0,0
Burkina Faso,88,9,1991,1990.1,79,77,3,4,5,4,1,1,0,3,2,0
Luxembourg,84,1,1991,1990.1,83,78,2,3,1,0,0,0,1,3,1,0
Gambia,73,4,1991,1990.1,69,79,5,2,3,1,1,0,1,2,3,0
Malta,71,10,1991,1990.1,61,80,4,6,4,6,1,1,2,4,1,1
Gabon,70,2,1991,1990.1,68,81,3,1,1,1,1,0,1,1,1,0
Sierra Leone,68,4,1991,1990.1,64,82,2,6,2,2,1,1,1,1,0,4
Mozambique,65,6,1991,1990.1,59,83,4,3,6,0,3,0,0,3,1,0
Guyana,64,10,1991,1990.1,54,84,5,2,8,2,1,1,2,1,2,0
Benin,59,3,1991,1990.1,56,85,3,5,1,2,0,1,2,4,1,0
Aruba,50,1,1991,1990.1,49,86,1,1,0,1,0,0,1,1,0,0
Cyprus,49,2,1991,1990.1,47,87,4,3,2,0,0,0,2,3,2,0
Niger,47,6,1991,1990.1,41,88,1,4,1,5,1,1,0,2,0,1
Guinea-Bissau,45,5,1991,1990.1,40,89,2,2,4,1,2,0,0,2,0,0
Albania,41,4,1991,1990.1,37,90,2,3,1,3,1,1,1,2,0,0
Mauritania,29,0,1991,1990.1,29,91,2,2,0,0,0,0,2,1,0,1
Swaziland,24,4,1991,1990.1,20,92,2,2,2,2,1,0,1,2,0,0
Faroe Islands,21,10,1991,1990.1,11,93,5,2,9,1,2,0,2,1,1,1
St. Lucia,21,15,1991,1990.1,6,94,4,3,11,4,3,1,0,1,1,1
Cape Verde,20,2,1991,1990.1,18,95,2,2,2,0,1,0,0,1,1,1
Chad,18,1,1991,1990.1,17,96,1,1,0,1,0,0,0,1,1,0
Botswana,15,3,1991,1990.1,12,97,2,2,2,1,1,0,0,1,1,1
Solomon Islands,12,7,1991,1990.1,5,98,1,3,2,5,1,1,0,0,0,2
Jersey,9,9,1991,1990.1,0,99,1,2,4,5,1,1,0,1,0,0
Cayman Islands,6,6,1991,1990.1,0,100,2,2,3,3,1,0,1,1,0,1
Dominican Republic,5,5,1991,1990.1,0,101,4,1,2,3,0,1,2,0,2,0
Anguilla,1,1,1991,1990.1,0,102,1,1,1,0,0,0,0,1,1,0
Guam,1,1,1991,1990.1,0,103,1,1,0,1,0,0,1,1,0,0
San Marino,1,1,1991,1990.1,0,104,3,3,1,0,0,0,3,3,0,0
Germany,1726,18,1992,1990.2,1708,1,4,10,3,15,1,4,0,4,3,2
Sweden,1448,22,1992,1990.2,1426,2,7,7,15,7,5,3,1,2,1,2
Hungary,1444,17,1992,1990.2,1427,3,5,6,5,12,2,3,2,1,1,2
England,1224,16,1992,1990.2,1208,4,4,8,8,8,2,2,0,2,2,4
Argentina,1113,12,1992,1990.2,1101,5,4,2,9,3,4,1,0,0,0,1
Brazil,1023,23,1992,1990.2,1000,6,6,4,19,4,5,2,1,1,0,1
Austria,972,18,1992,1990.2,954,7,5,5,13,5,2,0,1,3,2,2
Scotland,960,10,1992,1990.2,950,8,6,5,5,5,2,2,1,2,3,1
Denmark,946,11,1992,1990.2,935,9,6,7,5,6,2,2,1,2,3,3
Netherlands,894,22,1992,1990.2,872,10,8,4,17,5,4,1,1,2,3,1
Belgium,831,13,1992,1990.2,818,11,3,4,4,9,3,2,0,1,0,1
France,805,11,1992,1990.2,794,12,7,4,9,2,2,0,2,3,3,1
Czech Republic,793,11,1992,1990.2,782,13,5,3,10,1,1,0,1,2,3,1
Italy,793,15,1992,1990.2,778,14,4,5,7,8,2,3,0,0,2,2
Poland,784,13,1992,1990.2,771,15,4,7,4,9,3,2,0,2,1,3
Uruguay,784,11,1992,1990.2,773,16,7,1,9,2,4,1,2,0,1,0
South Korea,759,11,1992,1990.2,748,17,2,4,6,5,1,1,0,1,1,2
Norway,740,23,1992,1990.2,717,18,5,6,16,7,3,2,0,2,2,2
Switzerland,699,17,1992,1990.2,682,19,4,3,8,9,3,1,1,1,0,1
Russia,638,16,1992,1990.2,622,20,4,10,6,10,2,3,0,3,2,4
Spain,595,12,1992,1990.2,583,21,6,3,12,0,4,0,0,0,2,3
Bulgaria,545,13,1992,1990.2,532,22,3,5,4,9,1,3,1,2,1,0
Wales,541,11,1992,1990.2,530,23,1,8,6,5,1,3,0,4,0,1
Romania,532,21,1992,1990.2,511,24,5,3,17,4,4,1,0,2,1,0
Mexico,527,18,1992,1990.2,509,25,5,9,11,7,3,2,0,4,2,3
Zambia,509,17,1992,1990.2,492,26,2,10,2,15,1,6,1,3,0,1
Finland,482,6,1992,1990.2,476,27,4,5,1,5,0,0,3,2,1,3
Ghana,477,14,1992,1990.2,463,28,4,7,7,7,3,4,0,2,1,1
Northern Ireland,438,6,1992,1990.2,432,29,4,2,5,1,1,0,1,1,2,1
China,436,19,1992,1990.2,417,30,9,5,13,6,4,1,3,3,2,1
Indonesia,428,4,1992,1990.2,424,31,3,2,2,2,0,1,1,1,2,0
Ireland,373,15,1992,1990.2,358,32,7,3,14,1,5,0,2,1,0,2
Ivory Coast,368,16,1992,1990.2,352,33,5,7,11,5,3,1,0,3,2,3
Trinidad and Tobago,366,10,1992,1990.2,356,34,4,1,8,2,3,1,1,0,0,0
Kenya,363,11,1992,1990.2,352,35,3,6,4,7,1,2,1,3,1,1
Portugal,361,5,1992,1990.2,356,36,2,6,2,3,1,1,0,2,1,3
Malawi,360,7,1992,1990.2,353,37,5,4,2,5,1,2,1,1,3,1
Nigeria,351,16,1992,1990.2,335,38,5,4,10,6,4,3,1,0,0,1
Thailand,351,4,1992,1990.2,347,39,2,3,3,1,2,0,0,1,0,2
Costa Rica,350,19,1992,1990.2,331,40,6,7,13,6,4,0,1,5,1,2
Uganda,345,9,1992,1990.2,336,41,2,3,3,6,1,1,0,1,1,1
Iraq,326,17,1992,1990.2,309,42,1,3,1,16,1,2,0,1,0,0
Egypt,304,13,1992,1990.2,291,43,7,6,5,8,2,2,2,2,3,2
Algeria,290,7,1992,1990.2,283,44,5,4,7,0,2,0,1,2,2,2
Cameroon,288,17,1992,1990.2,271,45,7,8,10,7,3,2,2,2,2,4
Tunisia,287,10,1992,1990.2,277,46,6,1,10,0,2,0,1,0,3,1
Greece,281,8,1992,1990.2,273,47,4,3,4,4,2,2,1,1,1,0
Guinea,278,9,1992,1990.2,269,48,3,1,6,3,1,1,0,0,2,0
Democratic Republic of the Congo,271,13,1992,1990.2,258,49,3,5,8,5,3,1,0,2,0,2
New Zealand,265,15,1992,1990.2,250,50,2,1,11,4,2,1,0,0,0,0
Turkey,261,14,1992,1990.2,247,51,5,4,11,3,3,1,1,3,1,0
Morocco,259,12,1992,1990.2,247,52,4,4,9,3,2,1,0,2,2,1
Curaçao,251,2,1992,1990.2,249,53,1,3,1,1,0,1,0,2,1,0
Senegal,251,15,1992,1990.2,236,54,5,4,9,6,3,1,2,1,0,2
Kuwait,250,12,1992,1990.2,238,55,6,5,8,4,2,1,2,1,2,3
Congo,248,14,1992,1990.2,234,56,7,6,11,3,3,0,3,4,1,2
Japan,244,9,1992,1990.2,235,57,7,1,7,2,3,1,1,0,3,0
El Salvador,239,31,1992,1990.2,208,58,12,6,20,11,5,3,4,2,3,1
Mali,238,10,1992,1990.2,228,59,2,5,4,6,2,3,0,1,0,1
Guatemala,231,12,1992,1990.2,219,60,5,1,12,0,2,0,0,1,3,0
Australia,223,18,1992,1990.2,205,61,8,5,12,6,5,3,1,2,2,0
Ethiopia,212,16,1992,1990.2,196,62,7,4,14,2,3,0,3,4,1,0
Israel,211,12,1992,1990.2,199,63,5,5,6,6,1,1,3,1,1,3
Tanzania,203,9,1992,1990.2,194,64,6,2,8,1,2,0,1,1,3,1
Saudi Arabia,201,20,1992,1990.2,181,65,9,4,15,5,4,3,3,1,2,0
Honduras,200,34,1992,1990.2,166,66,8,6,26,8,6,2,0,2,2,2
Haiti,199,3,1992,1990.2,196,67,1,2,2,1,1,0,0,2,0,0
USA,195,21,1992,1990.2,174,68,13,8,17,4,5,1,5,6,3,1
Hong Kong,192,3,1992,1990.2,189,69,1,2,0,3,0,0,0,1,1,1
Ecuador,189,4,1992,1990.2,185,70,1,3,1,3,0,0,0,2,1,1
Latvia,186,7,1992,1990.2,179,71,5,7,5,2,1,0,2,5,2,2
Suriname,185,4,1992,1990.2,181,72,1,2,1,3,0,1,0,0,1,1
Iceland,183,5,1992,1990.2,178,73,2,6,0,5,0,2,2,3,0,1
Zimbabwe,180,12,1992,1990.2,168,74,5,3,11,1,4,1,1,0,0,2
Iran,167,12,1992,1990.2,155,75,3,4,8,4,1,1,0,1,2,2
Sudan,166,8,1992,1990.2,158,76,2,5,2,6,1,1,0,4,1,0
Estonia,160,3,1992,1990.2,157,77,3,2,2,1,0,0,1,1,2,1
United Arab Emirates,147,11,1992,1990.2,136,78,8,9,6,5,2,3,2,2,4,4
Qatar,146,20,1992,1990.2,126,79,10,3,18,2,5,0,2,2,3,1
Libya,144,1,1992,1990.2,143,80,2,2,0,1,0,0,1,2,1,0
Jamaica,141,16,1992,1990.2,125,81,6,11,7,9,3,3,1,6,2,2
Togo,139,2,1992,1990.2,137,82,4,3,2,0,1,0,1,3,2,0
Canada,135,18,1992,1990.2,117,83,7,4,16,2,4,0,3,0,0,4
New Caledonia,125,4,1992,1990.2,121,84,1,2,1,3,1,1,0,0,0,1
Mauritius,118,2,1992,1990.2,116,85,1,2,0,2,0,0,1,1,0,1
Panama,116,2,1992,1990.2,114,86,1,3,1,1,1,0,0,3,0,0
Bahrain,108,6,1992,1990.2,102,87,3,2,3,3,1,2,1,0,1,0
Guadeloupe,108,1,1992,1990.2,107,88,1,2,0,1,0,0,1,0,0,2
Lithuania,100,11,1992,1990.2,89,89,4,7,2,9,1,2,1,2,2,3
Burkina Faso,91,3,1992,1990.2,88,90,1,1,3,0,1,0,0,1,0,0
Madagascar,89,5,1992,1990.2,84,91,2,1,5,0,2,0,0,0,0,1
Luxembourg,86,2,1992,1990.2,84,92,2,1,2,0,0,0,2,1,0,0
Gabon,81,11,1992,1990.2,70,93,6,1,8,3,4,1,1,0,1,0
Fiji,77,12,1992,1990.2,65,94,3,3,7,5,2,2,0,1,1,0
Cuba,74,9,1992,1990.2,65,95,3,2,6,3,1,1,0,1,2,0
Malta,74,3,1992,1990.2,71,96,4,2,3,0,2,0,1,2,1,0
Mozambique,73,8,1992,1990.2,65,97,3,2,7,1,2,0,1,2,0,0
Sierra Leone,72,4,1992,1990.2,68,98,1,2,1,3,1,1,0,0,0,1
Guyana,66,2,1992,1990.2,64,99,2,1,1,1,0,0,2,0,0,1
Benin,62,3,1992,1990.2,59,100,2,3,1,2,0,0,2,3,0,0
Cyprus,62,13,1992,1990.2,49,101,6,4,7,6,2,2,3,2,1,0
Liberia,60,3,1992,1990.2,57,102,1,1,1,2,0,0,0,1,1,0
Barbados,57,4,1992,1990.2,53,103,2,2,2,2,1,1,1,1,0,0
Niger,51,4,1992,1990.2,47,104,5,3,1,3,0,2,4,0,1,1
Guinea-Bissau,50,5,1992,1990.2,45,105,3,4,4,1,2,0,1,3,0,1
Bermuda,46,15,1992,1990.2,31,106,6,6,6,9,3,1,1,4,2,1
Albania,44,3,1992,1990.2,41,107,3,3,3,0,2,0,0,3,1,0
Oman,43,1,1992,1990.2,42,108,2,5,0,1,0,0,2,5,0,0
Antigua and Barbuda,41,14,1992,1990.2,27,109,6,2,12,2,3,0,2,1,1,1
Pakistan,38,0,1992,1990.2,38,110,1,3,0,0,0,0,1,3,0,0
Lesotho,31,13,1992,1990.2,18,111,6,2,9,4,2,1,0,1,4,0
Swaziland,30,6,1992,1990.2,24,112,3,2,5,1,2,0,0,2,1,0
Croatia,29,4,1992,1990.2,25,113,1,3,3,1,1,0,0,2,0,1
Vanuatu,25,2,1992,1990.2,23,114,5,2,2,0,0,0,5,2,0,0
Nicaragua,24,2,1992,1990.2,22,115,1,2,0,2,0,0,1,2,0,0
Cape Verde,22,2,1992,1990.2,20,116,1,2,1,1,1,0,0,2,0,0
Faroe Islands,22,1,1992,1990.2,21,117,3,4,1,0,0,0,2,4,1,0
Chad,18,0,1992,1990.2,18,118,2,3,0,0,0,0,2,3,0,0
Solomon Islands,18,6,1992,1990.2,12,119,1,4,1,5,0,1,1,3,0,0
Botswana,16,1,1992,1990.2,15,120,4,4,1,0,0,0,4,2,0,2
South Africa,14,6,1992,1990.2,8,121,5,2,5,1,2,0,2,2,1,0
Uzbekistan,14,14,1992,1990.2,0,122,3,4,6,8,2,1,0,2,1,1
Puerto Rico,12,4,1992,1990.2,8,123,2,2,1,3,0,1,1,1,1,0
Burundi,11,6,1992,1990.2,5,124,2,3,2,4,2,1,0,1,0,1
Moldova,11,11,1992,1990.2,0,125,3,4,8,3,2,1,0,2,1,1
Turkmenistan,10,10,1992,1990.2,0,126,4,2,9,1,2,0,0,2,2,0
Kazakhstan,8,8,1992,1990.2,0,127,4,3,5,3,4,0,0,0,0,3
Seychelles,8,3,1992,1990.2,5,128,1,1,2,1,0,0,1,1,0,0
Dominican Republic,7,2,1992,1990.2,5,129,1,1,1,1,0,0,1,0,0,1
Georgia,6,6,1992,1990.2,0,130,1,2,6,0,1,0,0,2,0,0
Tajikistan,5,5,1992,1990.2,0,131,1,1,2,3,0,0,0,0,1,1
Kyrgyzstan,3,3,1992,1990.2,0,132,2,3,3,0,0,0,1,3,1,0
Ukraine,3,3,1992,1990.2,0,133,1,3,1,2,0,0,1,1,0,2
Namibia,2,2,1992,1990.2,0,134,1,4,0,2,0,0,1,3,0,1
San Marino,2,1,1992,1990.2,1,135,1,3,0,1,0,0,1,3,0,0
Anguilla,1,0,1992,1990.2,1,136,1,1,0,0,0,0,1,1,0,0
Germany,1754,28,1993,1990.3,1726,1,3,8,13,15,3,4,0,1,0,3
Sweden,1464,16,1993,1990.3,1448,2,5,4,11,5,3,1,1,1,1,2
Hungary,1451,7,1993,1990.3,1444,3,5,4,2,5,1,2,3,2,1,0
England,1247,23,1993,1990.3,1224,4,4,7,12,11,2,2,1,3,1,2
Argentina,1132,19,1993,1990.3,1113,5,11,6,12,7,5,2,1,1,5,3
Brazil,1063,40,1993,1990.3,1023,6,13,8,29,11,6,3,1,2,6,3
Austria,984,12,1993,1990.3,972,7,5,4,9,3,3,0,1,3,1,1
Scotland,973,13,1993,1990.3,960,8,4,4,7,6,2,2,1,2,1,0
Denmark,963,17,1993,1990.3,946,9,5,5,12,5,5,1,0,1,0,3
Netherlands,917,23,1993,1990.3,894,10,4,3,11,12,3,2,0,0,1,1
Belgium,840,9,1993,1990.3,831,11,3,3,5,4,2,1,0,2,1,0
France,821,16,1993,1990.3,805,12,4,4,8,8,2,3,2,0,0,1
Italy,813,20,1993,1990.3,793,13,5,3,14,6,5,2,0,1,0,0
Czech Republic,810,17,1993,1990.3,793,14,3,6,9,8,2,2,0,1,1,3
South Korea,807,48,1993,1990.3,759,15,15,11,30,18,7,6,3,3,5,2
Uruguay,804,20,1993,1990.3,784,16,7,8,13,7,4,3,0,4,3,1
Poland,796,12,1993,1990.3,784,17,6,8,6,6,2,1,2,3,2,4
Norway,765,25,1993,1990.3,740,18,4,6,7,18,4,3,0,1,0,2
Switzerland,711,12,1993,1990.3,699,19,3,5,6,6,2,3,0,1,1,1
Russia,660,22,1993,1990.3,638,20,2,11,4,18,1,5,0,3,1,3
Spain,617,22,1993,1990.3,595,21,5,4,12,10,4,3,0,1,1,0
Mexico,599,72,1993,1990.3,527,22,18,13,51,21,12,5,2,4,4,4
Bulgaria,560,15,1993,1990.3,545,23,4,5,9,6,2,2,0,3,2,0
Romania,554,22,1993,1990.3,532,24,3,9,5,17,3,4,0,3,0,2
Wales,553,12,1993,1990.3,541,25,4,3,7,5,2,1,1,1,1,1
Paraguay,549,11,1993,1990.3,538,26,6,8,7,4,3,0,1,5,2,3
Zambia,537,28,1993,1990.3,509,27,8,6,21,7,6,2,1,2,1,2
Chile,519,11,1993,1990.3,508,28,3,6,3,8,1,3,1,3,1,0
Ghana,498,21,1993,1990.3,477,29,8,6,11,10,4,3,1,3,3,0
Finland,496,14,1993,1990.3,482,30,5,9,6,8,2,2,1,5,2,2
China,458,22,1993,1990.3,436,31,4,8,10,12,4,3,0,5,0,0
Northern Ireland,447,9,1993,1990.3,438,32,2,6,3,6,1,3,0,3,1,0
Malaysia,443,22,1993,1990.3,421,33,7,4,17,5,3,1,1,3,3,0
Indonesia,433,5,1993,1990.3,428,34,3,5,3,2,1,0,2,5,0,0
Ireland,390,17,1993,1990.3,373,35,6,4,11,6,3,3,2,0,1,1
Portugal,380,19,1993,1990.3,361,36,6,4,15,4,4,2,1,1,1,1
Ivory Coast,378,10,1993,1990.3,368,37,4,5,7,3,4,1,0,2,0,2
Costa Rica,376,26,1993,1990.3,350,38,7,10,16,10,5,2,2,4,0,4
Peru,376,15,1993,1990.3,361,39,10,10,11,4,2,1,5,5,3,4
Malawi,374,14,1993,1990.3,360,40,6,5,8,6,3,2,2,2,1,1
Kenya,373,10,1993,1990.3,363,41,4,2,9,1,4,1,0,0,0,1
Trinidad and Tobago,373,7,1993,1990.3,366,42,2,3,4,3,1,0,0,2,1,1
Nigeria,369,18,1993,1990.3,351,43,4,5,16,2,4,0,0,2,0,3
Thailand,367,16,1993,1990.3,351,44,5,9,6,10,3,2,2,5,0,2
Iraq,364,38,1993,1990.3,326,45,7,7,17,21,4,3,0,1,3,3
Uganda,354,9,1993,1990.3,345,46,4,3,6,3,3,0,0,2,1,1
Egypt,324,20,1993,1990.3,304,47,6,7,12,8,4,3,0,2,2,2
Tunisia,309,22,1993,1990.3,287,48,7,3,16,6,5,1,1,0,1,2
Cameroon,307,19,1993,1990.3,288,49,7,9,10,9,4,3,0,2,3,4
Algeria,305,15,1993,1990.3,290,50,5,5,8,7,2,2,0,2,3,1
Singapore,305,12,1993,1990.3,293,51,5,4,5,7,3,2,1,2,1,0
Guinea,293,15,1993,1990.3,278,52,6,9,10,5,4,0,2,5,0,4
Greece,290,9,1993,1990.3,281,53,2,4,3,6,2,2,0,1,0,1
Kuwait,283,33,1993,1990.3,250,54,7,7,16,17,5,3,1,2,1,2
Democratic Republic of the Congo,280,9,1993,1990.3,271,55,3,3,8,1,1,0,2,0,0,3
Japan,280,36,1993,1990.3,244,56,9,6,22,14,7,3,2,0,0,3
Morocco,279,20,1993,1990.3,259,57,8,5,12,8,6,3,1,1,1,1
New Zealand,273,8,1993,1990.3,265,58,3,3,7,1,2,0,1,3,0,0
Senegal,273,22,1993,1990.3,251,59,9,9,14,8,3,3,3,5,3,1
Turkey,267,6,1993,1990.3,261,60,3,3,4,2,2,0,1,2,0,1
El Salvador,251,12,1993,1990.3,239,61,8,5,11,1,2,0,3,5,3,0
Mali,250,12,1993,1990.3,238,62,6,9,7,5,3,2,2,6,1,1
Saudi Arabia,249,48,1993,1990.3,201,63,12,6,36,12,10,2,1,0,1,4
Congo,248,0,1993,1990.3,248,64,3,2,0,0,0,0,1,2,2,0
USA,236,41,1993,1990.3,195,65,23,9,36,5,8,1,7,6,8,2
Australia,234,11,1993,1990.3,223,66,5,5,8,3,3,1,1,3,1,1
Colombia,230,28,1993,1990.3,202,67,10,8,16,12,5,4,0,0,5,4
Honduras,226,26,1993,1990.3,200,68,11,6,22,4,6,0,2,5,3,1
Israel,223,12,1993,1990.3,211,69,5,7,4,8,0,1,2,2,3,4
Ethiopia,216,4,1993,1990.3,212,70,4,3,4,0,1,0,1,3,2,0
Ecuador,215,26,1993,1990.3,189,71,14,4,25,1,7,0,4,3,3,1
Bolivia,209,33,1993,1990.3,176,72,8,14,20,13,6,1,2,6,0,7
Tanzania,207,4,1993,1990.3,203,73,2,3,2,2,1,0,1,3,0,0
Hong Kong,203,11,1993,1990.3,192,74,6,4,6,5,1,1,4,2,1,1
Zimbabwe,197,17,1993,1990.3,180,75,7,7,11,6,6,2,0,2,1,3
Iran,192,25,1993,1990.3,167,76,9,4,18,7,5,2,2,1,2,1
Latvia,192,6,1993,1990.3,186,77,5,4,2,4,0,2,3,2,2,0
Iceland,190,7,1993,1990.3,183,78,4,3,4,3,2,0,1,1,1,2
India,190,11,1993,1990.3,179,79,8,4,5,6,0,1,5,2,3,1
Martinique,189,14,1993,1990.3,175,80,4,5,7,7,2,1,0,2,2,2
United Arab Emirates,171,24,1993,1990.3,147,81,10,3,19,5,7,2,2,1,1,0
Qatar,167,21,1993,1990.3,146,82,5,3,13,8,3,2,2,1,0,0
Estonia,165,5,1993,1990.3,160,83,7,7,2,3,1,1,6,5,0,1
Jamaica,156,15,1993,1990.3,141,84,7,4,11,4,3,1,0,3,4,0
Canada,154,19,1993,1990.3,135,85,8,6,13,6,4,2,2,3,2,1
Togo,141,2,1993,1990.3,139,86,3,2,2,0,0,0,2,1,1,1
Mauritius,119,1,1993,1990.3,118,87,2,2,1,0,0,0,2,1,0,1
Bahrain,117,9,1993,1990.3,108,88,4,4,5,4,2,1,0,2,2,1
Lithuania,110,10,1993,1990.3,100,89,5,9,4,6,1,1,4,5,0,3
Guadeloupe,109,1,1993,1990.3,108,90,2,1,1,0,0,0,2,1,0,0
Syria,108,14,1993,1990.3,94,91,3,4,11,3,2,0,0,1,1,3
Burkina Faso,95,4,1993,1990.3,91,92,2,1,3,1,2,0,0,0,0,1
Gabon,94,13,1993,1990.3,81,93,6,7,9,4,2,1,3,4,1,2
Luxembourg,88,2,1993,1990.3,86,94,3,3,2,0,0,0,2,3,1,0
Gambia,83,10,1993,1990.3,73,95,4,2,7,3,2,1,2,0,0,1
Sierra Leone,83,11,1993,1990.3,72,96,7,4,10,1,3,0,1,2,3,2
Malta,78,4,1993,1990.3,74,97,3,6,0,4,0,2,3,4,0,0
Mozambique,76,3,1993,1990.3,73,98,3,2,1,2,0,0,0,1,3,1
Cyprus,69,7,1993,1990.3,62,99,5,3,6,1,1,0,1,3,3,0
Angola,68,3,1993,1990.3,65,100,2,2,1,2,0,1,0,1,2,0
Benin,67,5,1993,1990.3,62,101,4,4,2,3,1,0,3,3,0,1
Jordan,63,18,1993,1990.3,45,102,5,8,6,12,1,3,1,4,3,1
Niger,61,10,1993,1990.3,51,103,4,5,8,2,2,0,0,5,2,0
Guinea-Bissau,54,4,1993,1990.3,50,104,4,3,4,0,2,0,2,2,0,1
Venezuela,50,12,1993,1990.3,38,105,6,9,4,8,1,0,3,6,2,3
Albania,48,4,1993,1990.3,44,106,4,3,3,1,0,0,4,2,0,1
Antigua and Barbuda,48,7,1993,1990.3,41,107,1,1,3,4,1,1,0,0,0,0
Oman,47,4,1993,1990.3,43,108,4,2,3,1,2,0,1,1,1,1
Bangladesh,42,10,1993,1990.3,32,109,4,5,8,2,2,1,2,4,0,0
Pakistan,40,2,1993,1990.3,38,110,5,5,0,2,0,0,5,5,0,0
Lebanon,39,9,1993,1990.3,30,111,5,5,5,4,1,2,1,2,3,1
Dominica,36,3,1993,1990.3,33,112,1,1,2,1,0,0,1,0,0,1
Lesotho,33,2,1993,1990.3,31,113,2,2,2,0,0,0,0,2,2,0
Swaziland,33,3,1993,1990.3,30,114,2,5,0,3,0,1,1,3,1,1
Sri Lanka,30,0,1993,1990.3,30,115,4,4,0,0,0,0,4,4,0,0
St. Kitts and Nevis,27,12,1993,1990.3,15,116,3,4,8,4,2,0,0,3,1,1
Faroe Islands,23,1,1993,1990.3,22,117,4,2,0,1,0,0,4,2,0,0
Jersey,22,13,1993,1990.3,9,118,2,2,9,4,2,2,0,0,0,0
Turkmenistan,22,12,1993,1990.3,10,119,1,3,6,6,1,1,0,2,0,0
South Africa,21,7,1993,1990.3,14,120,3,5,1,6,0,3,0,2,3,0
Yemen,20,12,1993,1990.3,8,121,4,4,8,4,2,1,1,2,1,1
Puerto Rico,19,7,1993,1990.3,12,122,2,3,5,2,2,1,0,2,0,0
Botswana,17,1,1993,1990.3,16,123,2,1,0,1,0,0,1,1,1,0
Burundi,13,2,1993,1990.3,11,124,3,2,2,0,0,0,0,1,3,1
Dominican Republic,12,5,1993,1990.3,7,125,1,1,3,2,1,0,0,0,0,1
Ukraine,11,8,1993,1990.3,3,126,1,5,1,7,0,3,0,2,1,0
Cayman Islands,10,4,1993,1990.3,6,127,1,3,1,3,0,0,1,3,0,0
Greenland,10,8,1993,1990.3,2,128,2,1,6,2,1,0,1,1,0,0
Macau,7,1,1993,1990.3,6,129,3,3,1,0,0,0,3,3,0,0
Kyrgyzstan,6,3,1993,1990.3,3,130,1,1,1,2,0,0,0,1,1,0
Vietnam,4,4,1993,1990.3,0,131,3,3,3,1,1,0,2,3,0,0
Isle of Man,3,3,1993,1990.3,0,132,1,1,2,1,1,0,0,1,0,0
San Marino,3,1,1993,1990.3,2,133,4,3,1,0,0,0,3,3,1,0
Slovenia,3,3,1993,1990.3,0,134,2,1,3,0,1,0,1,1,0,0
Namibia,2,0,1993,1990.3,2,135,1,1,0,0,0,0,1,1,0,0
Gibraltar,1,1,1993,1990.3,0,136,1,1,1,0,0,0,1,1,0,0
Germany,1782,28,1994,1990.4,1754,1,7,8,12,16,5,6,1,1,1,1
Sweden,1500,36,1994,1990.4,1464,2,7,12,18,18,6,4,1,3,0,5
Hungary,1463,12,1994,1990.4,1451,3,5,7,5,7,0,0,2,6,3,1
Argentina,1153,21,1994,1990.4,1132,4,5,7,10,11,4,2,1,3,0,2
Brazil,1094,31,1994,1990.4,1063,5,7,6,13,18,5,5,0,0,2,1
Austria,996,12,1994,1990.4,984,6,5,3,4,8,0,2,4,1,1,0
Scotland,984,11,1994,1990.4,973,7,3,4,6,5,1,2,1,2,1,0
Denmark,974,11,1994,1990.4,963,8,4,4,9,2,4,0,0,3,0,1
Netherlands,951,34,1994,1990.4,917,9,8,7,21,13,5,4,2,1,1,2
Belgium,852,12,1994,1990.4,840,10,7,3,9,3,4,0,2,3,1,0
Italy,833,20,1994,1990.4,813,11,9,7,11,9,5,4,3,1,1,2
France,832,11,1994,1990.4,821,12,3,5,5,6,1,3,0,0,2,2
Czech Republic,830,20,1994,1990.4,810,13,2,6,11,9,2,2,0,1,0,3
South Korea,826,19,1994,1990.4,807,14,7,7,8,11,3,1,1,3,3,3
Poland,811,15,1994,1990.4,796,15,6,5,9,6,3,2,1,1,2,2
Norway,779,14,1994,1990.4,765,16,5,9,5,9,3,3,0,3,2,3
Switzerland,737,26,1994,1990.4,711,17,6,9,11,15,5,4,1,2,0,3
Russia,683,23,1994,1990.4,660,18,4,8,12,11,3,3,1,2,0,3
Spain,647,30,1994,1990.4,617,19,7,8,13,17,3,6,1,1,3,1
Mexico,616,17,1994,1990.4,599,20,9,3,16,1,4,0,2,2,3,1
Bulgaria,584,24,1994,1990.4,560,21,6,8,14,10,4,2,1,2,1,4
Romania,580,26,1994,1990.4,554,22,9,7,18,8,5,3,1,1,3,3
Zambia,564,27,1994,1990.4,537,23,8,8,14,13,6,3,0,4,2,1
Wales,560,7,1994,1990.4,553,24,4,3,3,4,1,1,3,2,0,0
Chile,530,11,1994,1990.4,519,25,4,3,6,5,1,2,2,1,1,0
Finland,517,21,1994,1990.4,496,26,4,10,10,11,2,2,2,5,0,3
Ghana,516,18,1994,1990.4,498,27,6,9,7,11,4,3,1,4,1,2
Northern Ireland,456,9,1994,1990.4,447,28,4,3,7,2,2,1,2,2,0,0
Ireland,408,18,1994,1990.4,390,29,5,7,6,12,2,5,1,2,2,0
Ivory Coast,405,27,1994,1990.4,378,30,5,11,18,9,5,3,0,5,0,3
Portugal,396,16,1994,1990.4,380,31,2,4,9,7,2,2,0,0,0,2
Nigeria,394,25,1994,1990.4,369,32,9,7,18,7,5,2,1,4,3,1
Trinidad and Tobago,388,15,1994,1990.4,373,33,4,2,13,2,3,1,1,1,0,0
Kenya,381,8,1994,1990.4,373,34,5,2,8,0,3,0,2,2,0,0
Peru,380,4,1994,1990.4,376,35,2,5,2,2,1,0,1,3,0,2
Costa Rica,379,3,1994,1990.4,376,36,2,1,0,3,0,1,1,0,1,0
Malawi,379,5,1994,1990.4,374,37,3,2,3,2,1,0,2,1,0,1
Thailand,370,3,1994,1990.4,367,38,1,1,1,2,0,0,0,0,1,1
Uganda,364,10,1994,1990.4,354,39,4,3,7,3,2,1,0,1,2,1
Egypt,346,22,1994,1990.4,324,40,11,4,20,2,6,1,3,1,2,2
Tunisia,327,18,1994,1990.4,309,41,7,4,12,6,4,1,1,1,2,2
Cameroon,322,15,1994,1990.4,307,42,5,10,5,10,1,1,2,4,2,5
Greece,308,18,1994,1990.4,290,43,8,6,12,6,4,1,2,4,2,1
Algeria,307,2,1994,1990.4,305,44,1,3,1,1,0,0,0,1,1,2
Guinea,304,11,1994,1990.4,293,45,3,6,7,4,2,1,1,3,0,2
Morocco,292,13,1994,1990.4,279,46,5,8,5,8,2,1,1,4,2,3
Democratic Republic of the Congo,289,9,1994,1990.4,280,47,4,7,4,5,1,1,1,5,2,1
Kuwait,289,6,1994,1990.4,283,48,4,5,3,3,1,1,2,2,1,2
Senegal,286,13,1994,1990.4,273,49,3,10,5,8,2,2,0,6,1,2
Saudi Arabia,279,30,1994,1990.4,249,50,13,13,15,15,6,6,5,5,2,2
Turkey,279,12,1994,1990.4,267,51,4,3,7,5,1,1,3,1,0,1
USA,267,31,1994,1990.4,236,52,22,5,26,5,7,1,5,4,10,0
Mali,265,15,1994,1990.4,250,53,8,10,4,11,2,4,1,5,5,1
Congo,254,6,1994,1990.4,248,54,3,2,5,1,2,0,0,1,1,1
El Salvador,254,3,1994,1990.4,251,55,2,1,3,0,1,0,1,1,0,0
Colombia,250,20,1994,1990.4,230,56,9,6,12,8,5,3,2,1,2,2
Israel,238,15,1994,1990.4,223,57,8,2,12,3,4,1,2,0,2,1
Australia,237,3,1994,1990.4,234,58,4,2,2,1,2,0,1,0,1,2
Honduras,232,6,1994,1990.4,226,59,3,2,4,2,1,0,2,1,0,1
Tanzania,225,18,1994,1990.4,207,60,6,2,16,2,5,1,0,1,1,0
Bolivia,218,9,1994,1990.4,209,61,6,10,3,6,1,2,2,4,3,4
Ecuador,218,3,1994,1990.4,215,62,3,1,3,0,2,0,0,1,1,0
Ethiopia,217,1,1994,1990.4,216,63,1,2,0,1,0,0,0,2,1,0
Zimbabwe,203,6,1994,1990.4,197,64,2,3,4,2,1,0,0,3,1,0
Martinique,201,12,1994,1990.4,189,65,4,1,10,2,3,0,0,1,1,0
Iceland,199,9,1994,1990.4,190,66,5,5,6,3,3,2,2,3,0,0
Latvia,199,7,1994,1990.4,192,67,5,3,4,3,1,2,3,1,1,0
India,195,5,1994,1990.4,190,68,3,1,1,4,0,1,3,0,0,0
Suriname,193,8,1994,1990.4,185,69,3,4,5,3,2,0,0,4,1,0
United Arab Emirates,183,12,1994,1990.4,171,70,10,4,11,1,4,0,3,2,3,2
Qatar,176,9,1994,1990.4,167,71,6,3,8,1,3,0,2,2,1,1
Jamaica,170,14,1994,1990.4,156,72,2,1,12,2,1,0,1,1,0,0
Sudan,168,2,1994,1990.4,166,73,1,3,0,2,0,0,0,1,1,2
Estonia,166,1,1994,1990.4,165,74,5,7,1,0,0,0,5,6,0,1
Togo,149,8,1994,1990.4,141,75,2,4,4,4,2,0,0,2,0,2
Lithuania,124,14,1994,1990.4,110,76,3,5,5,9,2,2,0,3,1,0
Guadeloupe,122,13,1994,1990.4,109,77,2,1,11,2,2,0,0,1,0,0
Bahrain,121,4,1994,1990.4,117,78,2,2,3,1,1,0,0,1,1,1
Gabon,102,8,1994,1990.4,94,79,4,3,7,1,3,0,0,3,1,0
Burkina Faso,99,4,1994,1990.4,95,80,4,2,3,1,1,0,1,1,2,1
Luxembourg,89,1,1994,1990.4,88,81,2,2,1,0,0,0,2,2,0,0
Malta,89,11,1994,1990.4,78,82,8,5,8,3,2,0,4,3,2,2
Fiji,85,8,1994,1990.4,77,83,1,4,3,5,1,2,0,2,0,0
Gambia,85,2,1994,1990.4,83,84,2,1,1,1,0,0,1,0,1,1
Mozambique,83,7,1994,1990.4,76,85,2,2,5,2,2,1,0,1,0,0
Niger,78,17,1994,1990.4,61,86,3,5,8,9,2,1,1,3,0,1
Cyprus,77,8,1994,1990.4,69,87,3,4,5,3,2,0,1,3,0,1
Angola,73,5,1994,1990.4,68,88,2,2,4,1,2,0,0,1,0,1
Liberia,64,4,1994,1990.4,60,89,3,2,2,2,1,0,0,1,2,1
Oman,64,17,1994,1990.4,47,90,10,4,9,8,3,2,3,2,4,0
Antigua and Barbuda,58,10,1994,1990.4,48,91,1,1,8,2,1,0,0,1,0,0
Guinea-Bissau,57,3,1994,1990.4,54,92,2,1,2,1,0,0,2,0,0,1
Albania,51,3,1994,1990.4,48,93,2,3,1,2,0,0,2,3,0,0
Papua New Guinea,48,2,1994,1990.4,46,94,2,2,1,1,1,0,1,1,0,1
Grenada,45,4,1994,1990.4,41,95,2,2,2,2,1,0,1,1,0,1
Croatia,44,15,1994,1990.4,29,96,2,6,2,13,1,4,0,1,1,1
Dominica,42,6,1994,1990.4,36,97,1,1,3,3,1,1,0,0,0,0
Mauritania,32,3,1994,1990.4,29,98,3,2,3,0,0,0,1,0,2,2
Vanuatu,30,5,1994,1990.4,25,99,3,1,5,0,0,0,2,1,1,0
Slovakia,26,14,1994,1990.4,12,100,3,7,5,9,1,2,0,4,2,1
Somalia,26,3,1994,1990.4,23,101,1,2,2,1,1,0,0,2,0,0
Faroe Islands,25,2,1994,1990.4,23,102,1,2,1,1,0,0,1,2,0,0
South Africa,25,4,1994,1990.4,21,103,3,4,2,2,1,1,0,2,2,1
Botswana,21,4,1994,1990.4,17,104,2,2,0,4,0,1,2,1,0,0
Cayman Islands,21,11,1994,1990.4,10,105,3,2,10,1,2,0,1,1,0,1
Georgia,20,14,1994,1990.4,6,106,5,6,8,6,2,3,2,3,1,0
Ukraine,19,8,1994,1990.4,11,107,5,4,7,1,2,0,1,3,2,1
Moldova,17,6,1994,1990.4,11,108,2,4,3,3,1,1,1,2,0,1
Belarus,15,4,1994,1990.4,11,109,2,3,2,2,1,0,1,2,0,1
Macedonia,14,14,1994,1990.4,0,110,7,1,13,1,4,0,2,0,1,1
Slovenia,13,10,1994,1990.4,3,111,4,6,7,3,1,3,1,1,2,2
Kazakhstan,9,1,1994,1990.4,8,112,3,1,1,0,1,0,0,1,2,0
Namibia,9,7,1994,1990.4,2,113,3,2,6,1,2,1,1,1,0,0
Tonga,8,4,1994,1990.4,4,114,1,1,2,2,1,0,0,0,0,1
Kyrgyzstan,7,1,1994,1990.4,6,115,2,2,1,0,0,0,2,1,0,1
Tajikistan,7,2,1994,1990.4,5,116,1,3,0,2,0,1,1,1,0,1
Liechtenstein,5,1,1994,1990.4,4,117,2,4,0,1,0,0,2,4,0,0
Armenia,1,1,1994,1990.4,0,118,2,3,1,0,1,0,0,3,1,0
Azerbaijan,0,0,1994,1990.4,0,119,1,3,0,0,0,0,1,3,0,0
Germany,1808,26,1995,1990.5,1782,1,5,7,16,10,4,4,0,1,1,2
Sweden,1515,15,1995,1990.5,1500,2,6,5,8,7,2,0,0,3,4,2
Hungary,1474,11,1995,1990.5,1463,3,5,5,7,4,3,1,1,3,1,1
England,1247,23,1994,1990.4,1224,4,4,7,12,11,2,2,1,3,1,2
England,1257,10,1995,1990.5,1247,4,7,2,10,0,2,0,1,1,4,1
Argentina,1183,30,1995,1990.5,1153,5,10,6,21,9,7,1,2,2,1,3
Brazil,1131,37,1995,1990.5,1094,6,10,7,23,14,8,6,0,0,2,1
Austria,1020,24,1995,1990.5,996,7,4,3,16,8,3,1,0,2,1,0
Scotland,997,13,1995,1990.5,984,8,3,6,7,6,3,3,0,1,0,2
Denmark,995,21,1995,1990.5,974,9,6,5,12,9,4,4,0,0,2,1
Netherlands,966,15,1995,1990.5,951,10,5,4,8,7,3,2,2,2,0,0
Belgium,866,14,1995,1990.5,852,11,4,4,5,9,2,2,2,0,0,2
France,853,21,1995,1990.5,832,12,4,4,17,4,3,2,0,0,1,2
Czech Republic,852,22,1995,1990.5,830,13,5,5,16,6,5,2,0,1,0,2
Italy,850,17,1995,1990.5,833,14,4,5,12,5,4,3,0,1,0,1
South Korea,837,11,1995,1990.5,826,15,6,4,5,6,2,1,3,0,1,3
Uruguay,831,27,1995,1990.5,804,16,9,8,21,6,6,0,0,5,3,3
Poland,822,11,1995,1990.5,811,17,3,4,8,3,2,0,0,2,1,2
Norway,804,25,1995,1990.5,779,18,6,7,11,14,3,3,0,3,3,1
Switzerland,748,11,1995,1990.5,737,19,4,5,5,6,1,1,3,1,0,3
Russia,715,32,1995,1990.5,683,20,4,6,8,24,3,5,0,1,1,0
Spain,665,18,1995,1990.5,647,21,7,2,15,3,4,1,0,0,3,1
Mexico,636,20,1995,1990.5,616,22,11,6,15,5,4,1,4,2,3,3
Bulgaria,602,18,1995,1990.5,584,23,5,8,9,9,3,2,0,4,2,2
Romania,592,12,1995,1990.5,580,24,3,5,5,7,2,2,1,1,0,2
Zambia,586,22,1995,1990.5,564,25,5,8,10,12,4,2,0,4,1,2
Wales,565,5,1995,1990.5,560,26,3,3,2,3,1,0,2,1,0,2
Paraguay,564,15,1995,1990.5,549,27,5,6,8,7,3,3,0,2,2,1
Chile,542,12,1995,1990.5,530,28,6,5,7,5,2,2,1,3,3,0
Finland,530,13,1995,1990.5,517,29,4,7,2,11,1,2,2,4,1,1
Ghana,528,12,1995,1990.5,516,30,2,8,4,8,2,3,0,5,0,0
Northern Ireland,470,14,1995,1990.5,456,31,2,6,6,8,1,2,1,2,0,2
China,462,4,1995,1990.5,458,32,3,2,3,1,1,0,1,0,1,2
Ivory Coast,425,20,1995,1990.5,405,33,9,5,15,5,5,1,1,0,3,4
Trinidad and Tobago,420,32,1995,1990.5,388,34,5,7,10,22,4,3,0,4,1,0
Ireland,415,7,1995,1990.5,408,35,6,3,6,1,3,0,2,2,1,1
Portugal,414,18,1995,1990.5,396,36,3,6,7,11,2,2,0,1,1,3
Nigeria,405,11,1995,1990.5,394,37,2,6,1,10,1,2,0,3,1,1
Peru,392,12,1995,1990.5,380,38,3,4,11,1,2,0,1,3,0,1
Costa Rica,387,8,1995,1990.5,379,39,2,7,3,5,1,1,1,5,0,1
Kenya,384,3,1995,1990.5,381,40,2,1,3,0,2,0,0,0,0,1
Malawi,383,4,1995,1990.5,379,41,2,3,1,3,0,1,2,0,0,2
Thailand,379,9,1995,1990.5,370,42,2,2,3,6,1,1,1,1,0,0
Iraq,374,10,1995,1990.5,364,43,3,2,7,3,3,1,0,0,0,1
Uganda,369,5,1995,1990.5,364,44,5,3,4,1,2,0,0,1,3,2
Egypt,367,21,1995,1990.5,346,45,6,9,14,7,3,3,1,2,2,4
Tunisia,345,18,1995,1990.5,327,46,7,8,14,4,6,1,0,4,1,3
Cameroon,336,14,1995,1990.5,322,47,4,7,6,8,3,2,0,4,1,1
Algeria,325,18,1995,1990.5,307,48,7,6,13,5,4,1,0,4,3,1
Greece,325,17,1995,1990.5,308,49,5,6,7,10,2,2,2,4,1,0
Guinea,320,16,1995,1990.5,304,50,5,4,15,1,4,0,0,4,1,0
Japan,307,27,1995,1990.5,280,51,11,7,16,11,4,2,4,4,3,1
Democratic Republic of the Congo,302,13,1995,1990.5,289,52,4,1,12,1,3,1,0,0,1,0
Senegal,301,15,1995,1990.5,286,53,5,5,12,3,3,1,0,3,2,1
Turkey,301,22,1995,1990.5,279,54,5,9,9,13,4,5,0,0,1,4
Morocco,299,7,1995,1990.5,292,55,5,1,7,0,3,0,0,1,2,0
Saudi Arabia,289,10,1995,1990.5,279,56,3,5,3,7,1,0,2,4,0,1
USA,287,20,1995,1990.5,267,57,10,4,16,4,4,1,3,3,3,0
Mali,281,16,1995,1990.5,265,58,7,10,10,6,3,1,3,9,1,0
New Zealand,281,8,1995,1990.5,273,59,3,4,4,4,1,0,1,3,1,1
Colombia,265,15,1995,1990.5,250,60,5,12,9,6,4,1,0,5,1,6
Curaçao,262,11,1995,1990.5,251,61,2,3,5,6,1,2,0,1,1,0
Congo,261,7,1995,1990.5,254,62,3,3,3,4,1,0,2,1,0,2
Israel,255,17,1995,1990.5,238,63,5,6,10,7,3,1,1,5,1,0
Australia,245,8,1995,1990.5,237,64,6,2,8,0,4,0,2,1,0,1
Honduras,241,9,1995,1990.5,232,65,5,2,8,1,3,0,1,1,1,1
Tanzania,241,16,1995,1990.5,225,66,5,4,14,2,3,0,1,4,1,0
Guatemala,233,2,1995,1990.5,231,67,1,3,1,1,1,1,0,2,0,0
Bolivia,230,12,1995,1990.5,218,68,3,7,3,9,0,2,0,3,3,2
Ecuador,230,12,1995,1990.5,218,69,3,7,6,6,2,2,1,4,0,1
Ethiopia,228,11,1995,1990.5,217,70,5,4,8,3,3,0,1,3,1,1
Zimbabwe,214,11,1995,1990.5,203,71,2,7,5,6,1,1,0,4,1,2
Latvia,213,14,1995,1990.5,199,72,5,5,8,6,4,1,1,4,0,0
Iceland,205,6,1995,1990.5,199,73,4,3,4,2,2,0,1,1,1,2
Martinique,203,2,1995,1990.5,201,74,1,1,1,1,0,0,0,1,1,0
India,199,4,1995,1990.5,195,75,4,2,2,2,1,0,1,1,2,1
Jamaica,199,29,1995,1990.5,170,76,12,6,16,13,8,3,1,3,3,0
Sudan,175,7,1995,1990.5,168,77,3,2,7,0,3,0,0,2,0,0
Estonia,170,4,1995,1990.5,166,78,5,7,1,3,0,0,5,7,0,0
Canada,165,11,1995,1990.5,154,79,7,1,11,0,3,0,3,1,1,0
Togo,154,5,1995,1990.5,149,80,4,3,3,2,1,0,1,2,2,1
Lithuania,144,20,1995,1990.5,124,81,7,5,11,9,3,2,2,3,2,0
New Caledonia,134,9,1995,1990.5,125,82,1,1,0,9,0,1,1,0,0,0
Gabon,123,21,1995,1990.5,102,83,6,4,11,10,3,3,2,1,1,0
Panama,123,7,1995,1990.5,116,84,1,3,2,5,1,1,0,2,0,0
Mauritius,119,0,1995,1990.5,119,85,2,1,0,0,0,0,2,1,0,0
Burkina Faso,106,7,1995,1990.5,99,86,3,3,5,2,0,0,1,1,2,2
Sierra Leone,102,19,1995,1990.5,83,87,7,6,15,4,7,1,0,3,0,2
Mozambique,98,15,1995,1990.5,83,88,4,5,10,5,4,1,0,2,0,2
Cuba,96,22,1995,1990.5,74,89,3,5,14,8,3,3,0,1,0,1
Luxembourg,94,5,1995,1990.5,89,90,4,4,2,3,2,1,1,3,1,0
Malta,92,3,1995,1990.5,89,91,4,4,2,1,1,0,3,3,0,1
Cyprus,88,11,1995,1990.5,77,92,7,3,11,0,1,0,2,3,4,0
Gambia,88,3,1995,1990.5,85,93,1,4,1,2,0,0,0,3,1,1
Angola,85,12,1995,1990.5,73,94,4,2,9,3,4,1,0,1,0,0
Niger,81,3,1995,1990.5,78,95,1,3,1,2,0,0,0,3,1,0
Liberia,72,8,1995,1990.5,64,96,4,6,7,1,3,0,0,3,1,3
Barbados,66,9,1995,1990.5,57,97,3,3,4,5,1,1,1,2,1,0
Guyana,66,0,1995,1990.5,66,98,1,1,0,0,0,0,1,1,0,0
Antigua and Barbuda,62,4,1995,1990.5,58,99,2,2,3,1,0,0,1,1,1,1
Guinea-Bissau,61,4,1995,1990.5,57,100,2,3,4,0,2,0,0,3,0,0
Albania,60,9,1995,1990.5,51,101,3,4,5,4,1,1,0,3,2,0
Croatia,60,16,1995,1990.5,44,102,4,3,14,2,3,1,0,1,1,1
Papua New Guinea,59,11,1995,1990.5,48,103,1,2,0,11,0,1,1,0,0,1
Aruba,55,5,1995,1990.5,50,104,1,1,3,2,0,0,1,1,0,0
Venezuela,55,5,1995,1990.5,50,105,1,5,1,4,0,0,1,4,0,1
Grenada,48,3,1995,1990.5,45,106,2,1,3,0,2,0,0,1,0,0
Bangladesh,47,5,1995,1990.5,42,107,1,5,1,4,1,2,0,2,0,1
Pakistan,41,1,1995,1990.5,40,108,1,1,1,0,1,0,0,1,0,0
Mauritania,40,8,1995,1990.5,32,109,7,6,6,2,3,1,1,4,3,1
Slovakia,39,13,1995,1990.5,26,110,6,3,12,1,4,1,1,2,1,0
Sri Lanka,35,5,1995,1990.5,30,111,3,2,5,0,2,0,0,2,1,0
Lesotho,34,1,1995,1990.5,33,112,2,2,0,1,0,0,2,2,0,0
Faroe Islands,33,8,1995,1990.5,25,113,4,4,5,3,1,1,3,3,0,0
St. Kitts and Nevis,31,4,1995,1990.5,27,114,2,2,1,3,0,1,1,0,1,1
St. Lucia,30,9,1995,1990.5,21,115,3,5,6,3,2,0,1,4,0,1
Georgia,28,8,1995,1990.5,20,116,3,3,4,4,2,1,1,2,0,0
Jersey,27,5,1995,1990.5,22,117,1,3,3,2,1,1,0,2,0,0
Ukraine,27,8,1995,1990.5,19,118,2,5,1,7,1,2,1,3,0,0
Slovenia,26,13,1995,1990.5,13,119,3,5,7,6,2,2,1,3,0,0
Cape Verde,25,3,1995,1990.5,22,120,2,2,2,1,2,0,0,1,0,1
Nicaragua,24,0,1995,1990.5,24,121,1,1,0,0,0,0,1,1,0,0
Botswana,23,2,1995,1990.5,21,122,3,3,2,0,0,0,2,3,1,0
Moldova,23,6,1995,1990.5,17,123,3,3,5,1,1,0,2,3,0,0
Belarus,22,7,1995,1990.5,15,124,3,5,2,5,1,1,1,2,1,2
Nepal,20,3,1995,1990.5,17,125,2,1,2,1,1,0,1,1,0,0
Uzbekistan,20,6,1995,1990.5,14,126,2,5,4,2,0,1,2,3,0,1
Macedonia,19,5,1995,1990.5,14,127,3,5,1,4,0,0,2,3,1,2
Greenland,15,5,1995,1990.5,10,128,1,1,4,1,1,1,0,0,0,0
Serbia,13,13,1995,1990.5,0,129,2,4,2,11,1,4,1,0,0,0
Namibia,12,3,1995,1990.5,9,130,1,4,0,3,0,0,0,3,1,1
Åland Islands,9,5,1995,1990.5,4,131,1,1,4,1,1,0,0,1,0,0
Armenia,6,5,1995,1990.5,1,132,4,3,2,3,0,1,3,2,1,0
Liechtenstein,5,0,1995,1990.5,5,133,3,2,0,0,0,0,2,2,1,0
Montserrat,4,4,1995,1990.5,0,134,1,1,3,1,1,1,0,0,0,0
San Marino,4,1,1995,1990.5,3,135,5,2,1,0,0,0,5,2,0,0
Anguilla,3,2,1995,1990.5,1,136,1,1,0,2,0,0,1,1,0,0
Azerbaijan,2,2,1995,1990.5,0,137,3,3,1,1,0,0,2,3,1,0
Guam,1,0,1995,1990.5,1,138,2,1,0,0,0,0,2,1,0,0
Germany,1841,33,1996,1990.6,1808,1,6,10,16,17,4,6,1,0,1,4
Sweden,1531,16,1996,1990.6,1515,2,4,7,7,9,2,4,2,1,0,2
Hungary,1482,8,1996,1990.6,1474,3,4,4,4,4,2,1,2,3,0,0
England,1278,21,1996,1990.6,1257,4,8,3,13,8,4,3,0,0,4,0
Argentina,1195,12,1996,1990.6,1183,5,4,3,7,5,1,1,1,1,2,1
Brazil,1161,30,1996,1990.6,1131,6,4,6,17,13,4,3,0,1,0,2
Austria,1027,7,1996,1990.6,1020,7,4,2,4,3,3,2,0,0,1,0
Denmark,1008,13,1996,1990.6,995,8,5,5,7,6,4,3,0,2,1,0
Scotland,1003,6,1996,1990.6,997,9,3,7,3,3,3,1,0,4,0,2
Netherlands,989,23,1996,1990.6,966,10,6,5,14,9,3,3,1,1,2,1
South Korea,881,44,1996,1990.6,837,11,8,8,28,16,5,3,2,3,1,2
Czech Republic,877,25,1996,1990.6,852,12,9,7,19,6,7,1,1,3,1,3
France,874,21,1996,1990.6,853,13,9,4,17,4,6,3,0,1,3,0
Belgium,873,7,1996,1990.6,866,14,4,2,2,5,1,1,2,0,1,1
Italy,861,11,1996,1990.6,850,15,4,3,5,6,2,2,0,1,2,0
Uruguay,841,10,1996,1990.6,831,16,3,5,3,7,2,1,1,3,0,1
Poland,830,8,1996,1990.6,822,17,6,4,6,2,2,0,1,4,3,0
Norway,816,12,1996,1990.6,804,18,4,3,9,3,3,2,0,1,1,0
Switzerland,756,8,1996,1990.6,748,19,4,6,3,5,1,1,3,3,0,2
Russia,748,33,1996,1990.6,715,20,7,8,15,18,4,5,1,1,2,2
Spain,685,20,1996,1990.6,665,21,4,7,8,12,3,3,0,0,1,4
Mexico,662,26,1996,1990.6,636,22,9,8,16,10,6,2,1,5,2,1
Bulgaria,622,20,1996,1990.6,602,23,3,8,8,12,3,3,0,3,0,2
Romania,614,22,1996,1990.6,592,24,7,4,15,7,4,2,3,2,0,0
Zambia,614,28,1996,1990.6,586,25,8,11,11,17,5,5,1,4,2,2
Wales,578,13,1996,1990.6,565,26,3,3,7,6,1,1,1,2,1,0
Paraguay,576,12,1996,1990.6,564,27,4,6,6,6,3,2,1,2,0,2
Chile,560,18,1996,1990.6,542,28,5,5,13,5,5,0,0,2,0,3
Ghana,548,20,1996,1990.6,528,29,6,16,8,12,5,2,1,7,0,7
Finland,538,8,1996,1990.6,530,30,3,6,5,3,0,1,2,4,1,1
China,490,28,1996,1990.6,462,31,7,7,12,16,2,3,4,4,1,0
Northern Ireland,476,6,1996,1990.6,470,32,6,1,5,1,1,0,3,0,2,1
Malaysia,467,24,1996,1990.6,443,33,4,4,16,8,3,1,0,1,1,2
Indonesia,466,33,1996,1990.6,433,34,7,10,21,12,3,1,3,7,1,2
Trinidad and Tobago,458,38,1996,1990.6,420,35,13,9,26,12,7,2,3,6,3,1
Thailand,440,61,1996,1990.6,379,36,12,7,37,24,8,4,2,2,2,1
Ireland,432,17,1996,1990.6,415,37,5,6,5,12,1,2,2,3,2,1
Ivory Coast,431,6,1996,1990.6,425,38,3,5,2,4,0,2,1,3,2,0
Portugal,427,13,1996,1990.6,414,39,5,7,4,9,3,3,1,2,1,2
Peru,410,18,1996,1990.6,392,40,7,5,17,1,4,0,1,4,2,1
Nigeria,409,4,1996,1990.6,405,41,2,2,3,1,1,0,1,2,0,0
Costa Rica,401,14,1996,1990.6,387,42,6,8,10,4,4,2,0,4,2,2
Kenya,395,11,1996,1990.6,384,43,4,9,6,5,3,1,1,6,0,2
Malawi,392,9,1996,1990.6,383,44,7,2,7,2,3,1,2,1,2,0
Iraq,388,14,1996,1990.6,374,45,2,5,7,7,2,3,0,2,0,0
Egypt,384,17,1996,1990.6,367,46,5,5,12,5,3,2,1,2,1,1
Uganda,382,13,1996,1990.6,369,47,7,5,9,4,2,1,2,1,3,3
Tunisia,367,22,1996,1990.6,345,48,5,9,10,12,4,3,0,5,1,1
Cameroon,345,9,1996,1990.6,336,49,1,5,2,7,1,1,0,2,0,2
Algeria,336,11,1996,1990.6,325,50,3,4,7,4,3,1,0,2,0,1
Greece,336,11,1996,1990.6,325,51,4,4,8,3,4,0,0,3,0,1
Japan,335,28,1996,1990.6,307,52,10,3,24,4,9,1,0,2,1,0
Saudi Arabia,334,45,1996,1990.6,289,53,18,6,40,5,13,1,3,1,2,4
Guinea,332,12,1996,1990.6,320,54,3,4,6,6,2,1,1,1,0,2
Kuwait,331,42,1996,1990.6,289,55,15,11,20,22,8,5,4,3,3,3
Morocco,329,30,1996,1990.6,299,56,6,4,20,10,5,2,0,1,1,1
Singapore,328,23,1996,1990.6,305,57,7,3,16,7,3,2,1,0,3,1
Turkey,320,19,1996,1990.6,301,58,6,8,15,4,4,2,2,4,0,2
Democratic Republic of the Congo,315,13,1996,1990.6,302,59,4,6,5,8,2,2,1,4,1,0
USA,315,28,1996,1990.6,287,60,12,4,23,5,9,1,2,2,1,1
Senegal,308,7,1996,1990.6,301,61,2,5,2,5,1,2,0,2,1,1
Myanmar,307,22,1996,1990.6,285,62,6,4,14,8,3,1,3,2,0,1
Colombia,292,27,1996,1990.6,265,63,7,6,18,9,7,3,0,1,0,2
Mali,292,11,1996,1990.6,281,64,2,7,2,9,1,2,0,3,1,2
El Salvador,277,23,1996,1990.6,254,65,9,7,16,7,4,1,4,4,1,2
Congo,268,7,1996,1990.6,261,66,4,3,5,2,3,0,0,2,1,1
Israel,268,13,1996,1990.6,255,67,5,4,12,1,3,0,1,4,1,0
Honduras,264,23,1996,1990.6,241,68,13,8,15,8,5,1,2,5,6,2
Curaçao,263,1,1996,1990.6,262,69,2,1,0,1,0,0,1,1,1,0
Australia,255,10,1996,1990.6,245,70,6,3,10,0,3,0,2,2,1,1
Ecuador,254,24,1996,1990.6,230,71,7,9,13,11,5,5,1,3,1,1
Bolivia,253,23,1996,1990.6,230,72,8,9,15,8,3,2,1,6,4,1
Guatemala,251,18,1996,1990.6,233,73,10,9,15,3,6,1,1,7,3,1
Tanzania,250,9,1996,1990.6,241,74,3,10,0,9,0,0,1,7,2,3
Iran,239,47,1996,1990.6,192,75,8,11,21,26,4,9,2,0,2,2
Ethiopia,233,5,1996,1990.6,228,76,3,1,4,1,1,0,1,0,1,1
Zimbabwe,227,13,1996,1990.6,214,77,5,3,7,6,1,2,1,1,3,0
Jamaica,223,24,1996,1990.6,199,78,10,11,18,6,8,2,0,7,2,2
Iceland,219,14,1996,1990.6,205,79,6,5,6,8,2,2,3,2,1,1
Latvia,218,5,1996,1990.6,213,80,4,4,2,3,0,0,3,2,1,2
Haiti,215,16,1996,1990.6,199,81,4,5,14,2,2,1,0,3,2,1
United Arab Emirates,215,32,1996,1990.6,183,82,17,9,23,9,9,3,1,4,7,2
Qatar,214,38,1996,1990.6,176,83,13,6,31,7,7,3,4,3,2,0
Martinique,208,5,1996,1990.6,203,84,3,3,3,2,2,1,0,2,1,0
India,205,6,1996,1990.6,199,85,1,4,2,4,1,0,0,3,0,1
Suriname,201,8,1996,1990.6,193,86,3,6,5,3,2,0,1,4,0,2
Estonia,186,16,1996,1990.6,170,87,7,5,8,8,2,1,1,2,4,2
Sudan,185,10,1996,1990.6,175,88,5,6,7,3,2,2,1,2,2,2
Canada,179,14,1996,1990.6,165,89,6,3,11,3,5,1,1,1,0,1
Togo,167,13,1996,1990.6,154,90,6,3,9,4,4,1,2,0,0,2
Lithuania,162,18,1996,1990.6,144,91,3,7,8,10,3,1,0,4,0,2
Panama,144,21,1996,1990.6,123,92,10,7,15,6,6,1,2,4,2,2
Gabon,143,20,1996,1990.6,123,93,9,8,9,11,2,5,2,1,5,2
Bahrain,128,7,1996,1990.6,121,94,1,6,1,6,0,1,1,3,0,2
Cuba,126,30,1996,1990.6,96,95,4,15,11,19,3,4,0,7,1,4
Syria,124,16,1996,1990.6,108,96,6,9,7,9,3,2,3,5,0,2
Mauritius,123,4,1996,1990.6,119,97,4,2,3,1,1,0,2,1,1,1
Burkina Faso,116,10,1996,1990.6,106,98,6,8,7,3,2,0,2,4,2,4
Sierra Leone,106,4,1996,1990.6,102,99,4,4,4,0,2,0,2,4,0,0
Mozambique,104,6,1996,1990.6,98,100,4,6,2,4,1,2,2,3,1,1
Oman,99,35,1996,1990.6,64,101,20,5,23,12,5,3,10,2,5,0
Angola,97,12,1996,1990.6,85,102,3,4,8,4,2,1,0,3,1,0
Cyprus,97,9,1996,1990.6,88,103,5,5,5,4,3,0,2,3,0,2
Luxembourg,96,2,1996,1990.6,94,104,3,2,2,0,0,0,2,2,1,0
Malta,94,2,1996,1990.6,92,105,5,6,1,1,0,0,4,5,1,1
Gambia,92,4,1996,1990.6,88,106,3,1,4,0,1,0,1,1,1,0
Madagascar,92,3,1996,1990.6,89,107,1,2,1,2,0,0,1,0,0,2
Croatia,82,22,1996,1990.6,60,108,8,5,16,6,5,1,1,1,2,3
Liberia,80,8,1996,1990.6,72,109,3,4,4,4,1,1,2,2,0,1
Benin,77,10,1996,1990.6,67,110,6,2,10,0,1,0,1,1,4,1
Barbados,70,4,1996,1990.6,66,111,4,3,3,1,2,1,2,2,0,0
Cambodia,70,1,1996,1990.6,69,112,1,3,1,0,0,0,1,3,0,0
Guyana,70,4,1996,1990.6,66,113,2,2,3,1,1,0,1,2,0,0
Antigua and Barbuda,66,4,1996,1990.6,62,114,1,1,1,3,0,0,1,0,0,1
Guinea-Bissau,65,4,1996,1990.6,61,115,1,1,3,1,1,0,0,1,0,0
Venezuela,63,8,1996,1990.6,55,116,5,9,3,5,0,2,4,5,1,2
Albania,62,2,1996,1990.6,60,117,2,2,1,1,0,0,1,2,1,0
Lebanon,61,22,1996,1990.6,39,118,11,2,21,1,6,1,3,0,2,1
Aruba,58,3,1996,1990.6,55,119,1,1,1,2,0,0,1,1,0,0
Grenada,58,10,1996,1990.6,48,120,2,3,6,4,1,2,1,1,0,0
Slovakia,58,19,1996,1990.6,39,121,4,4,13,6,3,1,0,3,1,0
Dominica,49,7,1996,1990.6,42,122,3,3,3,4,0,1,2,1,1,1
St. Kitts and Nevis,48,17,1996,1990.6,31,123,3,3,14,3,2,1,0,2,1,0
South Africa,46,21,1996,1990.6,25,124,12,1,20,1,9,1,2,0,1,0
Sri Lanka,44,9,1996,1990.6,35,125,4,5,4,5,1,2,2,3,1,0
Mauritania,41,1,1996,1990.6,40,126,3,2,0,1,0,0,0,2,3,0
Faroe Islands,40,7,1996,1990.6,33,127,3,4,4,3,0,0,3,3,0,1
Ukraine,39,12,1996,1990.6,27,128,2,4,7,5,2,1,0,2,0,1
Macedonia,37,18,1996,1990.6,19,129,3,5,4,14,2,2,1,2,0,1
Slovenia,36,10,1996,1990.6,26,130,2,5,2,8,0,1,1,2,1,2
Georgia,35,7,1996,1990.6,28,131,1,7,0,7,0,1,1,6,0,0
Serbia,35,22,1996,1990.6,13,132,4,5,11,11,4,2,0,2,0,1
St. Lucia,33,3,1996,1990.6,30,133,3,3,1,2,0,1,2,2,1,0
Swaziland,33,0,1996,1990.6,33,134,2,1,0,0,0,0,2,1,0,0
Belarus,32,10,1996,1990.6,22,135,5,5,6,4,1,0,1,4,3,1
Vietnam,31,27,1996,1990.6,4,136,4,5,14,13,2,3,1,1,1,1
Moldova,30,7,1996,1990.6,23,137,3,4,3,4,0,1,2,3,1,0
Uzbekistan,30,10,1996,1990.6,20,138,2,6,6,4,1,1,1,5,0,0
Jersey,28,1,1996,1990.6,27,139,1,1,0,1,0,1,0,0,1,0
Turkmenistan,27,5,1996,1990.6,22,140,4,3,3,2,0,1,2,2,2,0
Nicaragua,25,1,1996,1990.6,24,141,1,2,0,1,0,0,1,2,0,0
Botswana,23,0,1996,1990.6,23,142,1,1,0,0,0,0,0,1,1,0
Dominican Republic,22,10,1996,1990.6,12,143,3,5,6,4,2,1,1,2,0,2
Namibia,22,10,1996,1990.6,12,144,2,3,8,2,2,0,0,1,0,2
Nepal,22,2,1996,1990.6,20,145,3,3,0,2,0,0,3,3,0,0
Philippines,22,1,1996,1990.6,21,146,3,7,0,1,0,0,3,7,0,0
Yemen,22,2,1996,1990.6,20,147,1,3,1,1,1,0,0,3,0,0
Solomon Islands,20,2,1996,1990.6,18,148,1,1,1,1,0,0,0,0,1,1
Burundi,15,2,1996,1990.6,13,149,1,1,1,1,1,1,0,0,0,0
Macau,14,7,1996,1990.6,7,150,1,2,5,2,1,0,0,2,0,0
Armenia,11,5,1996,1990.6,6,151,3,6,1,4,0,1,2,3,1,2
Kazakhstan,11,2,1996,1990.6,9,152,2,3,1,1,1,0,1,3,0,0
Tajikistan,11,4,1996,1990.6,7,153,1,1,4,0,1,0,0,1,0,0
Kyrgyzstan,10,3,1996,1990.6,7,154,1,3,3,0,1,0,0,3,0,0
Seychelles,9,1,1996,1990.6,8,155,1,1,1,0,0,0,0,1,1,0
Azerbaijan,8,6,1996,1990.6,2,156,5,3,4,2,2,0,2,2,1,1
Brunei,8,1,1996,1990.6,7,157,2,2,1,0,1,0,1,2,0,0
Liechtenstein,8,3,1996,1990.6,5,158,2,3,1,2,0,0,2,3,0,0
Rwanda,6,5,1996,1990.6,1,159,2,4,1,4,0,0,1,3,1,1
Maldives,4,4,1996,1990.6,0,160,2,4,0,4,0,0,2,4,0,0
San Marino,4,0,1996,1990.6,4,161,2,2,0,0,0,0,2,2,0,0
Belize,2,2,1996,1990.6,0,162,1,1,1,1,0,0,1,1,0,0
Samoa,2,2,1996,1990.6,0,163,1,1,2,0,1,0,0,1,0,0
Guernsey,0,0,1996,1990.6,0,164,1,1,0,0,0,0,1,0,0,1
Germany,1862,21,1997,1990.7,1841,1,5,4,14,7,4,3,0,0,1,1
Sweden,1548,17,1997,1990.7,1531,2,5,8,7,10,4,5,0,2,1,1
Hungary,1497,15,1997,1990.7,1482,3,6,5,10,5,2,1,2,3,2,1
England,1295,17,1997,1990.7,1278,4,8,3,14,3,6,2,2,0,0,1
Brazil,1232,71,1997,1990.7,1161,5,14,10,51,20,14,6,0,1,0,3
Argentina,1212,17,1997,1990.7,1195,6,8,6,10,7,4,3,0,2,4,1
Austria,1041,14,1997,1990.7,1027,7,4,4,7,7,3,3,1,1,0,0
Scotland,1019,16,1997,1990.7,1003,8,5,5,10,6,4,2,1,2,0,1
Denmark,1016,8,1997,1990.7,1008,9,2,2,7,1,2,0,0,0,0,2
Netherlands,1005,16,1997,1990.7,989,10,3,4,7,9,2,2,0,2,1,0
South Korea,929,48,1997,1990.7,881,11,14,9,28,20,9,6,2,1,3,2
Czech Republic,899,22,1997,1990.7,877,12,6,7,10,12,4,3,2,3,0,1
Belgium,891,18,1997,1990.7,873,13,3,5,11,7,3,2,0,2,0,1
France,886,12,1997,1990.7,874,14,7,1,10,2,4,1,1,0,2,0
Italy,877,16,1997,1990.7,861,15,6,6,12,4,4,1,0,1,2,4
Uruguay,863,22,1997,1990.7,841,16,8,10,16,6,5,2,1,7,2,1
Poland,851,21,1997,1990.7,830,17,5,9,7,14,3,3,1,4,1,2
Norway,840,24,1997,1990.7,816,18,4,8,10,14,2,5,0,2,2,1
Switzerland,766,10,1997,1990.7,756,19,4,4,8,2,3,0,1,3,0,1
Russia,762,14,1997,1990.7,748,20,7,4,13,1,4,0,1,2,2,2
Mexico,706,44,1997,1990.7,662,21,11,13,26,18,6,3,1,5,4,5
Spain,697,12,1997,1990.7,685,22,4,2,9,3,3,1,0,0,1,1
Romania,642,28,1997,1990.7,614,23,4,4,17,11,4,2,0,0,0,2
Zambia,641,27,1997,1990.7,614,24,7,13,11,16,5,3,0,3,2,7
Bulgaria,634,12,1997,1990.7,622,25,4,1,10,2,4,0,0,1,0,0
Chile,598,38,1997,1990.7,560,26,10,7,31,7,7,1,3,4,0,2
Paraguay,595,19,1997,1990.7,576,27,8,8,13,6,6,2,2,4,0,2
Wales,586,8,1997,1990.7,578,28,2,4,1,7,0,1,1,3,1,0
Ghana,561,13,1997,1990.7,548,29,6,10,8,5,2,0,3,6,1,4
Finland,551,13,1997,1990.7,538,30,3,7,4,9,1,3,1,2,1,2
China,537,47,1997,1990.7,490,31,18,11,30,17,10,6,4,1,4,4
Indonesia,487,21,1997,1990.7,466,32,7,5,18,3,4,0,0,3,3,2
Northern Ireland,481,5,1997,1990.7,476,33,3,6,4,1,1,0,1,4,1,2
Trinidad and Tobago,477,19,1997,1990.7,458,34,6,6,11,8,2,1,2,4,2,1
Malaysia,474,7,1997,1990.7,467,35,6,2,6,1,3,1,1,1,2,0
Thailand,453,13,1997,1990.7,440,36,8,2,11,2,3,0,2,1,3,1
Ireland,446,14,1997,1990.7,432,37,4,6,7,7,1,1,0,3,3,2
Ivory Coast,446,15,1997,1990.7,431,38,6,3,13,2,5,1,0,1,1,1
Costa Rica,440,39,1997,1990.7,401,39,10,11,27,12,7,1,0,6,3,4
Portugal,434,7,1997,1990.7,427,40,4,3,6,1,3,0,1,0,0,3
Peru,431,21,1997,1990.7,410,41,10,9,15,6,8,3,1,5,1,1
Egypt,422,38,1997,1990.7,384,42,12,7,33,5,8,1,2,5,2,1
Nigeria,418,9,1997,1990.7,409,43,2,6,5,4,2,2,0,2,0,2
Iraq,410,22,1997,1990.7,388,44,3,7,8,14,2,5,1,1,0,1
Kenya,408,13,1997,1990.7,395,45,4,7,6,7,2,3,0,3,2,1
Malawi,402,10,1997,1990.7,392,46,4,3,4,6,0,1,1,2,3,0
Japan,394,59,1997,1990.7,335,47,13,9,36,23,7,4,3,1,3,4
Tunisia,383,16,1997,1990.7,367,48,9,3,14,2,7,1,1,1,1,1
Saudi Arabia,372,38,1997,1990.7,334,49,15,6,31,7,11,2,2,2,2,2
Cameroon,368,23,1997,1990.7,345,50,10,8,18,5,5,1,1,5,4,2
Kuwait,356,25,1997,1990.7,331,51,10,7,17,8,6,3,3,3,1,1
Morocco,351,22,1997,1990.7,329,52,6,5,14,8,6,3,0,1,0,1
Guinea,349,17,1997,1990.7,332,53,7,6,11,6,5,1,1,4,1,1
Algeria,348,12,1997,1990.7,336,54,4,10,2,10,1,4,3,2,0,4
Greece,346,10,1997,1990.7,336,55,4,3,2,8,1,2,1,0,2,1
USA,336,21,1997,1990.7,315,56,10,7,13,8,4,1,3,2,3,4
Turkey,335,15,1997,1990.7,320,57,4,4,9,6,2,1,1,1,1,2
Singapore,331,3,1997,1990.7,328,58,3,4,1,2,0,0,3,2,0,2
Democratic Republic of the Congo,325,10,1997,1990.7,315,59,6,5,6,4,1,1,1,3,4,1
Senegal,320,12,1997,1990.7,308,60,5,8,7,5,2,1,1,5,2,2
Mali,316,24,1997,1990.7,292,61,7,8,16,8,5,2,1,4,1,2
Colombia,311,19,1997,1990.7,292,62,7,11,10,9,5,0,2,7,0,4
Iran,303,64,1997,1990.7,239,63,9,13,26,38,5,6,0,4,4,3
New Zealand,295,14,1997,1990.7,281,64,4,6,12,2,2,1,2,5,0,0
Australia,294,39,1997,1990.7,255,65,8,8,27,12,6,5,0,2,2,1
El Salvador,293,16,1997,1990.7,277,66,11,9,14,2,3,0,3,6,5,3
Ecuador,279,25,1997,1990.7,254,67,5,14,9,16,3,4,0,6,2,4
Bolivia,278,25,1997,1990.7,253,68,12,6,22,3,9,0,2,5,1,1
Israel,278,10,1997,1990.7,268,69,4,5,3,7,1,2,2,3,1,0
Honduras,274,10,1997,1990.7,264,70,4,2,8,2,2,0,1,2,1,0
Congo,272,4,1997,1990.7,268,71,2,4,3,1,2,0,0,3,0,1
Jamaica,267,44,1997,1990.7,223,72,13,14,22,22,9,5,0,3,4,6
Guatemala,264,13,1997,1990.7,251,73,6,4,10,3,3,1,0,1,3,2
Tanzania,262,12,1997,1990.7,250,74,9,5,8,4,2,0,3,3,4,2
Zimbabwe,245,18,1997,1990.7,227,75,5,9,5,13,2,2,1,6,2,1
United Arab Emirates,239,24,1997,1990.7,215,76,12,6,18,6,6,2,4,2,2,2
Ethiopia,235,2,1997,1990.7,233,77,2,3,1,1,0,0,1,3,1,0
Latvia,234,16,1997,1990.7,218,78,7,7,11,5,4,2,2,5,1,0
Iceland,231,12,1997,1990.7,219,79,5,5,7,5,2,1,1,3,2,1
Martinique,228,20,1997,1990.7,208,80,6,3,18,2,6,1,0,2,0,0
India,221,16,1997,1990.7,205,81,8,1,14,2,3,0,2,0,3,1
Qatar,221,7,1997,1990.7,214,82,4,4,3,4,1,2,2,2,1,0
Hong Kong,206,3,1997,1990.7,203,83,2,2,3,0,1,0,1,2,0,0
Estonia,199,13,1997,1990.7,186,84,8,8,9,4,2,2,5,6,1,0
Togo,188,21,1997,1990.7,167,85,6,12,12,9,3,2,0,9,3,1
Canada,184,5,1997,1990.7,179,86,6,5,3,2,1,0,2,5,3,0
Lithuania,172,10,1997,1990.7,162,87,6,8,6,4,3,2,2,4,1,2
Syria,152,28,1997,1990.7,124,88,3,4,13,15,1,1,1,2,1,1
Gabon,149,6,1997,1990.7,143,89,4,4,4,2,2,0,1,3,1,1
Libya,148,4,1997,1990.7,144,90,2,2,3,1,1,0,0,1,1,1
Panama,146,2,1997,1990.7,144,91,1,3,1,1,0,1,0,2,1,0
Bahrain,135,7,1997,1990.7,128,92,4,4,4,3,2,0,1,4,1,0
Cuba,131,5,1997,1990.7,126,93,1,3,1,4,0,1,0,1,1,1
Burkina Faso,129,13,1997,1990.7,116,94,5,5,7,6,2,0,3,3,0,2
Mozambique,127,23,1997,1990.7,104,95,7,4,13,10,3,2,1,1,3,1
Mauritius,125,2,1997,1990.7,123,96,2,3,1,1,0,1,1,2,1,0
Sierra Leone,115,9,1997,1990.7,106,97,5,3,6,3,3,1,1,1,1,1
Oman,113,14,1997,1990.7,99,98,3,4,5,9,2,2,1,1,0,1
Cyprus,110,13,1997,1990.7,97,99,6,4,8,5,3,1,2,3,1,0
Angola,105,8,1997,1990.7,97,100,4,4,7,1,3,0,0,1,1,3
Malta,99,5,1997,1990.7,94,101,6,3,4,1,0,0,6,3,0,0
Croatia,98,16,1997,1990.7,82,102,4,5,7,9,1,2,0,2,3,1
Fiji,98,13,1997,1990.7,85,103,5,2,12,1,3,1,2,1,0,0
Luxembourg,97,1,1997,1990.7,96,104,2,3,1,0,0,0,2,3,0,0
Liberia,87,7,1997,1990.7,80,105,5,5,6,1,3,0,2,3,0,2
Benin,80,3,1997,1990.7,77,106,3,3,2,1,0,0,0,3,3,0
Barbados,75,5,1997,1990.7,70,107,2,2,2,3,0,2,0,0,2,0
Grenada,73,15,1997,1990.7,58,108,1,6,5,10,1,2,0,2,0,2
Lebanon,73,12,1997,1990.7,61,109,8,4,9,3,3,1,2,2,3,1
Cambodia,72,2,1997,1990.7,70,110,3,3,2,0,0,0,2,3,1,0
Guyana,71,1,1997,1990.7,70,111,1,2,0,1,0,0,1,2,0,0
Slovakia,71,13,1997,1990.7,58,112,5,6,8,5,3,2,1,3,1,1
Albania,68,6,1997,1990.7,62,113,3,4,3,3,1,0,2,4,0,0
Jordan,68,5,1997,1990.7,63,114,3,7,4,1,1,0,0,4,2,3
Venezuela,68,5,1997,1990.7,63,115,4,10,2,3,0,0,2,9,2,1
Serbia,64,29,1997,1990.7,35,116,4,9,8,21,2,5,0,0,2,4
Uzbekistan,63,33,1997,1990.7,30,117,7,7,22,11,4,2,2,2,1,3
Dominica,61,12,1997,1990.7,49,118,3,1,12,0,2,0,1,1,0,0
Papua New Guinea,61,2,1997,1990.7,59,119,2,2,1,1,1,0,1,2,0,0
South Africa,60,14,1997,1990.7,46,120,5,8,7,7,2,1,2,6,1,1
St. Kitts and Nevis,53,5,1997,1990.7,48,121,5,1,5,0,2,0,2,1,1,0
Bangladesh,50,3,1997,1990.7,47,122,3,4,2,1,0,0,3,3,0,1
Bermuda,50,4,1997,1990.7,46,123,1,2,2,2,1,0,0,2,0,0
Sri Lanka,50,6,1997,1990.7,44,124,2,2,3,3,1,1,1,1,0,0
Georgia,49,14,1997,1990.7,35,125,4,3,12,2,3,1,0,2,1,0
Faroe Islands,47,7,1997,1990.7,40,126,2,5,2,5,1,2,1,3,0,0
Pakistan,47,6,1997,1990.7,41,127,3,5,3,3,1,1,2,4,0,0
Ukraine,47,8,1997,1990.7,39,128,5,4,5,3,2,2,0,2,3,0
Mauritania,46,5,1997,1990.7,41,129,1,3,1,4,0,0,0,2,1,1
Macedonia,44,7,1997,1990.7,37,130,4,2,5,2,2,0,2,2,0,0
Slovenia,42,6,1997,1990.7,36,131,2,3,1,5,0,1,2,1,0,1
Lesotho,40,6,1997,1990.7,34,132,3,3,0,6,0,1,1,1,2,1
Solomon Islands,39,19,1997,1990.7,20,133,1,5,9,10,1,2,0,3,0,0
Turkmenistan,37,10,1997,1990.7,27,134,4,4,6,4,2,1,2,3,0,0
Belarus,36,4,1997,1990.7,32,135,4,4,3,1,0,0,4,4,0,0
Swaziland,36,3,1997,1990.7,33,136,3,3,3,0,1,0,2,0,0,3
Namibia,35,13,1997,1990.7,22,137,5,6,9,4,2,1,2,2,1,3
St. Lucia,35,2,1997,1990.7,33,138,1,3,1,1,0,0,1,2,0,1
Jersey,34,6,1997,1990.7,28,139,2,1,5,1,2,0,0,1,0,0
Kazakhstan,33,22,1997,1990.7,11,140,6,7,12,10,3,2,0,5,3,0
Vietnam,33,2,1997,1990.7,31,141,4,4,1,1,0,0,4,4,0,0
Yemen,32,10,1997,1990.7,22,142,3,3,8,2,1,1,1,1,1,1
Moldova,30,0,1997,1990.7,30,143,2,3,0,0,0,0,2,3,0,0
Cape Verde,28,3,1997,1990.7,25,144,1,2,2,1,0,0,0,2,1,0
Tajikistan,27,16,1997,1990.7,11,145,3,4,9,7,2,2,1,1,0,1
Botswana,25,2,1997,1990.7,23,146,3,1,2,0,0,0,2,0,1,1
Nepal,25,3,1997,1990.7,22,147,5,3,2,1,0,0,4,3,1,0
Kyrgyzstan,22,12,1997,1990.7,10,148,3,2,5,7,2,1,1,1,0,0
Macau,17,3,1997,1990.7,14,149,3,3,2,1,1,0,2,2,0,1
Armenia,16,5,1997,1990.7,11,150,3,6,3,2,1,0,1,5,1,1
Azerbaijan,13,5,1997,1990.7,8,151,4,6,4,1,1,0,3,5,0,1
Maldives,10,6,1997,1990.7,4,152,5,5,3,3,0,1,3,4,2,0
Liechtenstein,9,1,1997,1990.7,8,153,3,3,1,0,0,0,3,3,0,0
Gibraltar,8,7,1997,1990.7,1,154,1,1,5,2,1,0,0,1,0,0
Tonga,8,0,1997,1990.7,8,155,1,1,0,0,0,0,1,1,0,0
British Virgin Islands,5,5,1997,1990.7,0,156,1,1,4,1,1,0,0,1,0,0
San Marino,4,0,1997,1990.7,4,157,2,2,0,0,0,0,2,2,0,0
Belize,3,1,1997,1990.7,2,158,1,1,0,1,0,0,1,0,0,1
Germany,1894,32,1998,1990.8,1862,1,11,6,22,10,6,4,2,1,3,1
Sweden,1556,8,1998,1990.8,1548,2,5,4,7,1,4,1,0,2,1,1
Hungary,1513,16,1998,1990.8,1497,3,6,3,7,9,3,3,1,0,2,0
England,1313,18,1998,1990.8,1295,4,6,8,7,11,3,3,1,2,2,3
Brazil,1268,36,1998,1990.8,1232,5,13,5,27,9,7,3,2,2,4,0
Argentina,1234,22,1998,1990.8,1212,6,8,4,17,5,7,2,0,2,1,0
Austria,1064,23,1998,1990.8,1041,7,6,5,13,10,2,2,2,1,2,2
Netherlands,1036,31,1998,1990.8,1005,8,11,4,24,7,6,2,1,0,4,2
Denmark,1029,13,1998,1990.8,1016,9,3,10,2,11,0,3,3,4,0,3
Scotland,1027,8,1998,1990.8,1019,10,6,3,7,1,2,0,2,1,2,2
South Korea,951,22,1998,1990.8,929,11,6,14,8,14,2,5,1,4,3,5
France,917,31,1998,1990.8,886,12,10,8,21,10,8,3,0,1,2,4
Czech Republic,913,14,1998,1990.8,899,13,4,5,8,6,4,2,0,1,0,2
Belgium,902,11,1998,1990.8,891,14,9,2,11,0,3,0,1,0,5,2
Italy,897,20,1998,1990.8,877,15,8,3,18,2,6,1,0,1,2,1
Poland,870,19,1998,1990.8,851,16,4,6,10,9,4,3,0,3,0,0
Norway,869,29,1998,1990.8,840,17,5,9,14,15,2,3,1,1,2,5
Russia,772,10,1998,1990.8,762,18,3,8,4,6,2,0,1,6,0,2
Switzerland,770,4,1998,1990.8,766,19,3,4,3,1,0,0,0,3,3,1
Mexico,740,34,1998,1990.8,706,20,4,14,6,28,2,7,1,2,1,5
Spain,720,23,1998,1990.8,697,21,6,4,17,6,4,1,1,2,1,1
Romania,667,25,1998,1990.8,642,22,9,5,21,4,6,1,2,0,1,4
Zambia,655,14,1998,1990.8,641,23,6,7,7,7,2,3,1,1,3,3
Bulgaria,639,5,1998,1990.8,634,24,5,6,4,1,2,0,2,4,1,2
Chile,616,18,1998,1990.8,598,25,7,7,11,7,2,2,0,2,5,3
Paraguay,611,16,1998,1990.8,595,26,2,12,4,12,1,1,0,6,1,5
Wales,594,8,1998,1990.8,586,27,3,3,3,5,1,2,1,1,1,0
Ghana,574,13,1998,1990.8,561,28,5,5,6,7,2,4,2,0,1,1
Finland,561,10,1998,1990.8,551,29,4,6,3,7,1,2,2,1,1,3
China,545,8,1998,1990.8,537,30,3,3,2,6,1,2,1,0,1,1
Trinidad and Tobago,503,26,1998,1990.8,477,31,7,5,20,6,4,2,2,3,1,0
Indonesia,502,15,1998,1990.8,487,32,3,2,12,3,2,0,0,2,1,0
Northern Ireland,487,6,1998,1990.8,481,33,4,2,5,1,3,0,0,2,1,0
Malaysia,474,0,1998,1990.8,474,34,2,1,0,0,0,0,1,1,1,0
Thailand,473,20,1998,1990.8,453,35,9,2,17,3,4,0,2,1,3,1
Ivory Coast,463,17,1998,1990.8,446,36,5,5,14,3,4,1,0,1,1,3
Ireland,454,8,1998,1990.8,446,37,4,2,7,1,2,0,1,2,1,0
Costa Rica,449,9,1998,1990.8,440,38,1,2,1,8,0,1,1,1,0,0
Portugal,444,10,1998,1990.8,434,39,3,3,4,6,2,2,1,1,0,0
Egypt,441,19,1998,1990.8,422,40,6,10,4,15,1,3,2,2,3,5
Nigeria,428,10,1998,1990.8,418,41,3,7,3,7,1,2,2,3,0,2
Kenya,426,18,1998,1990.8,408,42,4,2,14,4,2,1,0,0,2,1
Japan,409,15,1998,1990.8,394,43,9,4,11,4,3,1,4,3,2,0
Malawi,409,7,1998,1990.8,402,44,9,1,6,1,3,0,3,1,3,0
Tunisia,409,26,1998,1990.8,383,45,9,8,20,6,6,1,1,5,2,2
Saudi Arabia,406,34,1998,1990.8,372,46,11,11,24,10,8,3,2,2,1,6
Uganda,393,11,1998,1990.8,382,47,3,1,11,0,2,0,0,0,1,1
Kuwait,388,32,1998,1990.8,356,48,7,6,19,13,4,3,1,2,2,1
Cameroon,383,15,1998,1990.8,368,49,7,7,9,6,3,3,2,2,2,2
Morocco,376,25,1998,1990.8,351,50,9,6,18,7,5,2,2,2,2,2
Algeria,355,7,1998,1990.8,348,51,2,5,3,4,1,1,1,3,0,1
Guinea,354,5,1998,1990.8,349,52,1,5,1,4,1,1,0,3,0,1
Greece,353,7,1998,1990.8,346,53,3,2,6,1,1,0,0,1,2,1
USA,351,15,1998,1990.8,336,54,13,3,12,3,5,1,4,2,4,0
Singapore,344,13,1998,1990.8,331,55,5,3,10,3,4,2,1,0,0,1
Turkey,341,6,1998,1990.8,335,56,4,2,6,0,2,0,2,2,0,0
Democratic Republic of the Congo,336,11,1998,1990.8,325,57,2,5,3,8,1,2,1,1,0,2
Mali,327,11,1998,1990.8,316,58,5,6,4,7,2,2,3,2,0,2
Senegal,327,7,1998,1990.8,320,59,2,4,4,3,2,0,0,3,0,1
Myanmar,322,15,1998,1990.8,307,60,3,2,12,3,3,0,0,1,0,1
Colombia,316,5,1998,1990.8,311,61,4,4,2,3,1,0,1,3,2,1
Australia,314,20,1998,1990.8,294,62,6,2,20,0,3,0,3,1,0,1
Iran,308,5,1998,1990.8,303,63,5,5,3,2,1,1,2,4,2,0
New Zealand,305,10,1998,1990.8,295,64,4,1,9,1,2,1,1,0,1,0
Israel,301,23,1998,1990.8,278,65,5,6,11,12,4,3,1,2,0,1
El Salvador,296,3,1998,1990.8,293,66,4,2,3,0,1,0,3,1,0,1
Jamaica,291,24,1998,1990.8,267,67,11,11,16,8,5,3,3,4,3,4
Honduras,284,10,1998,1990.8,274,68,1,4,1,9,0,2,1,1,0,1
Congo,274,2,1998,1990.8,272,69,1,2,0,2,0,1,0,0,1,1
Guatemala,272,8,1998,1990.8,264,70,4,1,7,1,0,0,1,0,3,1
Curaçao,269,6,1998,1990.8,263,71,2,3,0,6,0,1,2,1,0,1
Tanzania,264,2,1998,1990.8,262,72,1,5,0,2,0,0,1,4,0,1
United Arab Emirates,263,24,1998,1990.8,239,73,7,6,17,7,6,2,1,3,0,1
Zimbabwe,258,13,1998,1990.8,245,74,2,8,5,8,1,3,1,3,0,2
Latvia,249,15,1998,1990.8,234,75,4,8,5,10,2,2,2,5,0,1
Iceland,242,11,1998,1990.8,231,76,7,1,11,0,2,0,2,0,3,1
Martinique,241,13,1998,1990.8,228,77,2,3,9,4,2,1,0,2,0,0
Haiti,234,19,1998,1990.8,215,78,2,5,9,10,2,3,0,2,0,0
Qatar,234,13,1998,1990.8,221,79,8,3,10,3,3,0,1,2,4,1
Estonia,214,15,1998,1990.8,199,80,8,5,9,6,2,0,3,5,3,0
Hong Kong,208,2,1998,1990.8,206,81,2,2,1,1,0,0,1,2,1,0
Suriname,207,6,1998,1990.8,201,82,1,1,3,3,0,0,0,0,1,1
Togo,204,16,1998,1990.8,188,83,7,6,7,9,3,2,4,3,0,1
Sudan,195,10,1998,1990.8,185,84,1,6,2,8,0,1,1,3,0,2
Lithuania,180,8,1998,1990.8,172,85,5,6,5,3,1,1,1,4,3,1
Syria,169,17,1998,1990.8,152,86,3,8,6,11,2,4,0,3,1,1
Burkina Faso,156,27,1998,1990.8,129,87,15,7,20,7,6,1,2,4,7,2
Gabon,156,7,1998,1990.8,149,88,2,1,5,2,2,1,0,0,0,0
Libya,153,5,1998,1990.8,148,89,2,4,1,4,0,0,2,3,0,1
Mozambique,146,19,1998,1990.8,127,90,3,17,5,14,2,2,1,11,0,4
Cuba,137,6,1998,1990.8,131,91,2,2,4,2,1,0,1,1,0,1
Croatia,129,31,1998,1990.8,98,92,4,9,16,15,4,6,0,3,0,0
Mauritius,129,4,1998,1990.8,125,93,1,2,3,1,1,0,0,1,0,1
Guadeloupe,127,5,1998,1990.8,122,94,1,2,3,2,1,0,0,1,0,1
Oman,127,14,1998,1990.8,113,95,9,4,10,4,3,0,4,2,2,2
Cyprus,119,9,1998,1990.8,110,96,5,1,8,1,3,1,1,0,1,0
Angola,118,13,1998,1990.8,105,97,4,7,8,5,2,1,0,4,2,2
Fiji,110,12,1998,1990.8,98,98,4,3,9,3,3,1,0,2,1,0
Malta,106,7,1998,1990.8,99,99,8,2,7,0,1,0,6,2,1,0
Luxembourg,97,0,1998,1990.8,97,100,3,2,0,0,0,0,2,2,1,0
Liberia,92,5,1998,1990.8,87,101,2,2,3,2,1,0,1,2,0,0
Grenada,88,15,1998,1990.8,73,102,1,1,14,1,1,0,0,1,0,0
Niger,87,6,1998,1990.8,81,103,3,4,5,1,3,0,0,3,0,1
Serbia,84,20,1998,1990.8,64,104,6,9,10,10,5,2,0,3,1,4
Slovakia,84,13,1998,1990.8,71,105,5,6,4,9,1,3,2,2,2,1
Barbados,83,8,1998,1990.8,75,106,2,2,6,2,1,0,1,2,0,0
Benin,82,2,1998,1990.8,80,107,2,2,1,1,0,1,1,1,1,0
Antigua and Barbuda,81,15,1998,1990.8,66,108,6,2,13,2,3,0,1,2,2,0
Lebanon,81,8,1998,1990.8,73,109,5,4,7,1,1,0,2,3,2,1
Albania,79,11,1998,1990.8,68,110,3,5,2,9,0,1,1,2,2,2
South Africa,79,19,1998,1990.8,60,111,9,6,12,7,3,2,1,3,5,1
Cambodia,73,1,1998,1990.8,72,112,1,1,1,0,0,0,0,1,1,0
Jordan,73,5,1998,1990.8,68,113,1,4,1,4,0,2,0,2,1,0
Dominica,71,10,1998,1990.8,61,114,2,5,5,5,1,1,0,3,1,1
St. Kitts and Nevis,66,13,1998,1990.8,53,115,4,2,11,2,3,0,1,2,0,0
Papua New Guinea,65,4,1998,1990.8,61,116,1,4,1,3,1,0,0,3,0,1
Georgia,63,14,1998,1990.8,49,117,4,7,7,7,3,2,0,4,1,1
Macedonia,59,15,1998,1990.8,44,118,4,6,9,6,2,2,0,2,2,2
Ukraine,59,12,1998,1990.8,47,119,4,1,10,2,3,1,1,0,0,0
Namibia,57,22,1998,1990.8,35,120,5,9,8,14,3,1,1,6,1,2
Slovenia,52,10,1998,1990.8,42,121,4,5,4,6,1,1,2,3,1,1
Solomon Islands,49,10,1998,1990.8,39,122,3,2,8,2,3,0,0,1,0,1
Faroe Islands,48,1,1998,1990.8,47,123,1,3,0,1,0,0,1,2,0,1
Belarus,46,10,1998,1990.8,36,124,2,2,5,5,1,1,0,1,1,0
Lesotho,42,2,1998,1990.8,40,125,3,1,1,1,0,0,1,1,2,0
Vietnam,42,9,1998,1990.8,33,126,5,1,8,1,3,0,1,0,1,1
St. Lucia,41,6,1998,1990.8,35,127,3,1,5,1,2,0,1,0,0,1
Vanuatu,39,9,1998,1990.8,30,128,4,1,8,1,2,0,1,1,1,0
Moldova,38,8,1998,1990.8,30,129,1,6,1,7,0,1,1,3,0,2
Palestine,34,3,1998,1990.8,31,130,1,2,1,2,0,0,1,1,0,1
Botswana,28,3,1998,1990.8,25,131,2,3,1,2,0,0,1,1,1,2
Cape Verde,28,0,1998,1990.8,28,132,1,2,0,0,0,0,0,2,1,0
Cayman Islands,27,6,1998,1990.8,21,133,3,2,4,2,1,1,1,1,1,0
Dominican Republic,25,3,1998,1990.8,22,134,1,1,3,0,1,0,0,1,0,0
Laos,25,4,1998,1990.8,21,135,1,4,2,2,1,0,0,3,0,1
Armenia,22,6,1998,1990.8,16,136,4,1,6,0,3,0,0,1,1,0
Azerbaijan,22,9,1998,1990.8,13,137,6,4,8,1,5,0,1,2,0,2
Chad,19,1,1998,1990.8,18,138,1,1,1,0,0,0,0,0,1,1
Burundi,18,3,1998,1990.8,15,139,2,1,2,1,2,1,0,0,0,0
Guam,18,17,1998,1990.8,1,140,2,1,2,15,1,1,1,0,0,0
Tonga,13,5,1998,1990.8,8,141,1,2,3,2,1,0,0,1,0,1
Liechtenstein,11,2,1998,1990.8,9,142,2,2,2,0,1,0,1,2,0,0
Rwanda,10,4,1998,1990.8,6,143,3,1,4,0,1,0,0,1,2,0
Seychelles,10,1,1998,1990.8,9,144,1,1,0,1,0,0,1,0,0,1
Samoa,9,7,1998,1990.8,2,145,2,1,6,1,2,0,0,1,0,0
Cook Islands,8,8,1998,1990.8,0,146,3,2,8,0,2,0,0,2,1,0
São Tomé and Príncipe,3,0,1998,1990.8,3,147,1,1,0,0,0,0,1,1,0,0
Andorra,2,2,1998,1990.8,0,148,3,5,0,2,0,0,2,5,1,0
Equatorial Guinea,1,0,1998,1990.8,1,149,1,1,0,0,0,0,1,1,0,0
Germany,1917,23,1999,1990.9,1894,1,6,7,14,9,4,3,1,3,1,1
Sweden,1566,10,1999,1990.9,1556,2,5,6,7,3,4,3,0,2,1,1
Hungary,1523,10,1999,1990.9,1513,3,5,4,10,0,2,0,1,2,2,2
England,1328,15,1999,1990.9,1313,4,6,4,11,4,3,1,2,0,1,3
Brazil,1323,55,1999,1990.9,1268,5,13,9,42,13,12,4,0,3,1,2
Argentina,1254,20,1999,1990.9,1234,6,5,9,7,13,3,4,1,3,1,2
Austria,1079,15,1999,1990.9,1064,7,3,4,11,4,2,1,1,2,0,1
Netherlands,1049,13,1999,1990.9,1036,8,5,4,10,3,0,0,1,1,4,3
Denmark,1048,19,1999,1990.9,1029,9,7,4,8,11,3,4,1,0,3,0
Scotland,1036,9,1999,1990.9,1027,10,3,5,4,5,1,2,2,1,0,2
France,935,18,1999,1990.9,917,11,6,5,11,7,4,4,1,0,1,1
Czech Republic,934,21,1999,1990.9,913,12,4,6,10,11,4,4,0,1,0,1
Belgium,922,20,1999,1990.9,902,13,6,8,8,12,1,3,4,3,1,2
Italy,907,10,1999,1990.9,897,14,5,4,8,2,1,1,2,0,2,3
Norway,896,27,1999,1990.9,869,15,6,7,13,14,5,5,1,0,0,2
Poland,882,12,1999,1990.9,870,16,6,7,6,6,3,2,2,3,1,2
Uruguay,877,14,1999,1990.9,863,17,8,3,10,4,3,1,3,1,2,1
Russia,793,21,1999,1990.9,772,18,5,4,11,10,3,4,0,0,2,0
Switzerland,785,15,1999,1990.9,770,19,4,7,6,9,2,4,1,2,1,1
Mexico,777,37,1999,1990.9,740,20,15,9,23,14,6,5,3,3,6,1
Spain,763,43,1999,1990.9,720,21,7,3,32,11,5,3,1,0,1,0
Romania,688,21,1999,1990.9,667,22,7,4,10,11,4,3,1,0,2,1
Zambia,667,12,1999,1990.9,655,23,5,9,3,9,1,5,2,2,2,2
Bulgaria,650,11,1999,1990.9,639,24,4,7,7,4,2,2,1,4,1,1
Paraguay,634,23,1999,1990.9,611,25,8,9,12,11,4,5,2,2,2,2
Chile,631,15,1999,1990.9,616,26,6,5,11,4,4,0,2,2,0,3
Wales,596,2,1999,1990.9,594,27,2,3,0,2,0,1,2,2,0,0
Ghana,585,11,1999,1990.9,574,28,3,4,8,3,3,1,0,1,0,2
Finland,576,15,1999,1990.9,561,29,4,6,8,7,1,1,2,3,1,2
Trinidad and Tobago,534,31,1999,1990.9,503,30,8,2,27,4,8,0,0,1,0,1
Indonesia,522,20,1999,1990.9,502,31,2,3,12,8,2,1,0,0,0,2
Northern Ireland,490,3,1999,1990.9,487,32,4,4,1,2,0,1,3,2,1,1
Costa Rica,482,33,1999,1990.9,449,33,10,3,28,5,6,0,2,2,2,1
Malaysia,478,4,1999,1990.9,474,34,3,1,4,0,2,0,1,1,0,0
Ivory Coast,475,12,1999,1990.9,463,35,6,3,11,1,4,0,1,2,1,1
Portugal,473,29,1999,1990.9,444,36,6,2,23,6,5,1,0,0,1,1
Ireland,466,12,1999,1990.9,454,37,6,4,8,4,4,1,1,1,1,2
Egypt,457,16,1999,1990.9,441,38,6,8,4,12,1,3,4,0,1,5
Peru,450,19,1999,1990.9,431,39,6,7,10,9,4,1,1,2,1,4
Kenya,436,10,1999,1990.9,426,40,4,6,4,6,2,0,2,2,0,4
Nigeria,434,6,1999,1990.9,428,41,2,4,2,4,1,2,0,1,1,1
Iraq,427,17,1999,1990.9,410,42,4,4,11,6,3,2,0,0,1,2
Saudi Arabia,427,21,1999,1990.9,406,43,4,11,4,17,2,4,0,6,2,1
Tunisia,418,9,1999,1990.9,409,44,6,2,7,2,4,1,1,1,1,0
Malawi,415,6,1999,1990.9,409,45,7,2,6,0,0,0,4,2,3,0
Japan,413,4,1999,1990.9,409,46,4,3,1,3,0,0,1,2,3,1
Uganda,398,5,1999,1990.9,393,47,4,6,1,4,1,2,3,3,0,1
Cameroon,391,8,1999,1990.9,383,48,2,2,2,6,2,1,0,0,0,1
Morocco,385,9,1999,1990.9,376,49,3,5,3,6,2,2,0,2,1,1
Greece,382,29,1999,1990.9,353,50,14,4,24,5,9,2,2,1,3,1
USA,370,19,1999,1990.9,351,51,7,6,14,5,6,1,1,3,0,2
Algeria,362,7,1999,1990.9,355,52,2,2,6,1,2,0,0,1,0,1
Guinea,357,3,1999,1990.9,354,53,2,3,3,0,1,0,0,3,1,0
Turkey,352,11,1999,1990.9,341,54,2,5,2,9,1,2,0,0,1,3
Senegal,350,23,1999,1990.9,327,55,9,4,19,4,7,0,0,1,2,3
Democratic Republic of the Congo,344,8,1999,1990.9,336,56,4,3,5,3,2,2,1,1,1,0
Singapore,344,0,1999,1990.9,344,57,1,2,0,0,0,0,1,2,0,0
Colombia,339,23,1999,1990.9,316,58,3,11,8,15,1,3,0,5,2,3
Mali,339,12,1999,1990.9,327,59,4,5,11,1,3,0,0,2,1,3
Israel,332,31,1999,1990.9,301,60,8,5,27,4,6,1,2,4,0,0
Jamaica,318,27,1999,1990.9,291,61,9,11,17,10,4,2,2,8,3,1
New Zealand,318,13,1999,1990.9,305,62,3,9,1,12,0,2,2,4,1,3
Honduras,308,24,1999,1990.9,284,63,5,5,18,6,4,3,1,0,0,2
El Salvador,305,9,1999,1990.9,296,64,4,8,4,5,2,0,1,7,1,1
Ecuador,293,14,1999,1990.9,279,65,3,10,5,9,1,2,1,4,1,4
Guatemala,290,18,1999,1990.9,272,66,11,7,12,6,3,2,4,5,4,0
Congo,289,15,1999,1990.9,274,67,9,5,11,4,6,0,2,3,1,2
Bolivia,287,9,1999,1990.9,278,68,8,8,4,5,0,1,1,5,7,2
United Arab Emirates,282,19,1999,1990.9,263,69,7,1,19,0,4,0,1,1,2,0
Zimbabwe,272,14,1999,1990.9,258,70,6,3,12,2,4,1,0,1,2,1
Tanzania,266,2,1999,1990.9,264,71,1,2,2,0,1,0,0,1,0,1
Latvia,258,9,1999,1990.9,249,72,4,5,2,7,0,1,2,2,2,2
Iceland,257,15,1999,1990.9,242,73,3,7,5,10,2,4,1,2,0,1
Haiti,256,22,1999,1990.9,234,74,6,5,17,5,5,1,1,3,0,1
Martinique,244,3,1999,1990.9,241,75,1,1,2,1,1,0,0,1,0,0
India,235,14,1999,1990.9,221,76,6,2,10,4,3,1,1,1,2,0
Estonia,234,20,1999,1990.9,214,77,5,10,6,14,1,3,2,2,2,5
Hong Kong,219,11,1999,1990.9,208,78,3,2,9,2,2,1,0,1,1,0
Togo,213,9,1999,1990.9,204,79,1,9,2,7,0,0,1,7,0,2
Suriname,210,3,1999,1990.9,207,80,1,2,2,1,1,0,0,0,0,2
Canada,194,10,1999,1990.9,184,81,9,1,9,1,5,0,3,0,1,1
Lithuania,186,6,1999,1990.9,180,82,3,6,3,3,0,2,2,3,1,1
Gabon,181,25,1999,1990.9,156,83,12,6,19,6,8,1,1,4,3,1
Burkina Faso,180,24,1999,1990.9,156,84,7,7,14,10,5,1,0,4,2,2
Libya,164,11,1999,1990.9,153,85,4,2,8,3,4,1,0,1,0,0
Cuba,161,24,1999,1990.9,137,86,7,4,21,3,6,1,1,2,0,1
Mozambique,149,3,1999,1990.9,146,87,2,5,1,2,0,0,2,4,0,1
Croatia,143,14,1999,1990.9,129,88,7,6,9,5,3,0,1,3,3,3
Mauritius,140,11,1999,1990.9,129,89,3,4,4,7,0,2,0,2,3,0
Oman,137,10,1999,1990.9,127,90,6,2,9,1,2,0,2,2,2,0
Guadeloupe,135,8,1999,1990.9,127,91,3,3,4,4,3,0,0,3,0,0
Cyprus,132,13,1999,1990.9,119,92,6,3,12,1,3,0,2,3,1,0
Angola,130,12,1999,1990.9,118,93,3,6,5,7,1,3,1,1,1,2
Malta,111,5,1999,1990.9,106,94,5,3,3,2,0,0,5,2,0,1
Serbia,101,17,1999,1990.9,84,95,3,4,7,10,2,2,0,1,1,1
Luxembourg,100,3,1999,1990.9,97,96,4,3,3,0,0,0,4,3,0,0
Liberia,98,6,1999,1990.9,92,97,3,2,5,1,2,0,0,2,1,0
Madagascar,97,5,1999,1990.9,92,98,3,1,5,0,1,0,1,1,1,0
Grenada,96,8,1999,1990.9,88,99,2,4,2,6,1,2,0,2,1,0
South Africa,95,16,1999,1990.9,79,100,5,9,8,8,4,1,1,2,0,6
Slovakia,94,10,1999,1990.9,84,101,5,8,6,4,3,3,1,4,1,1
Barbados,92,9,1999,1990.9,83,102,3,2,7,2,3,0,0,1,0,1
Gambia,92,0,1999,1990.9,92,103,1,1,0,0,0,0,0,1,1,0
Albania,87,8,1999,1990.9,79,104,5,3,8,0,2,0,2,2,1,1
Antigua and Barbuda,87,6,1999,1990.9,81,105,1,7,1,5,0,2,0,4,1,1
Uzbekistan,87,24,1999,1990.9,63,106,2,5,8,16,2,4,0,1,0,0
Jordan,80,7,1999,1990.9,73,107,4,2,6,1,2,0,1,2,1,0
Dominica,79,8,1999,1990.9,71,108,3,5,4,4,2,0,1,4,0,1
Venezuela,78,10,1999,1990.9,68,109,5,7,7,3,2,0,1,6,2,1
Cambodia,77,4,1999,1990.9,73,110,2,2,1,3,0,0,2,2,0,0
St. Kitts and Nevis,75,9,1999,1990.9,66,111,2,3,8,1,2,0,0,3,0,0
Guyana,74,3,1999,1990.9,71,112,1,2,2,1,0,0,0,2,1,0
Slovenia,71,19,1999,1990.9,52,113,6,6,7,12,3,3,2,1,1,2
Georgia,70,7,1999,1990.9,63,114,5,3,5,2,0,0,3,3,2,0
Ukraine,70,11,1999,1990.9,59,115,5,6,7,4,1,2,0,1,4,3
Macedonia,64,5,1999,1990.9,59,116,3,3,4,1,0,0,1,3,2,0
Namibia,64,7,1999,1990.9,57,117,6,6,4,3,0,0,1,4,5,2
Bangladesh,61,11,1999,1990.9,50,118,2,6,2,9,1,2,1,2,0,2
St. Lucia,57,16,1999,1990.9,41,119,5,4,9,7,3,1,1,3,1,0
Sri Lanka,54,4,1999,1990.9,50,120,5,1,4,0,0,0,4,1,1,0
Swaziland,51,15,1999,1990.9,36,121,5,2,11,4,3,1,0,0,2,1
Belarus,50,4,1999,1990.9,46,122,4,5,1,3,0,0,3,3,1,2
Faroe Islands,49,1,1999,1990.9,48,123,4,1,1,0,0,0,3,1,1,0
Pakistan,47,0,1999,1990.9,47,124,1,1,0,0,0,0,1,1,0,0
Lesotho,45,3,1999,1990.9,42,125,4,1,2,1,1,0,3,1,0,0
Moldova,43,5,1999,1990.9,38,126,3,5,1,4,0,1,0,3,3,1
Jersey,40,6,1999,1990.9,34,127,1,3,1,5,1,1,0,2,0,0
Cayman Islands,39,12,1999,1990.9,27,128,3,4,9,3,2,0,1,4,0,0
Turkmenistan,39,2,1999,1990.9,37,129,1,2,1,1,0,0,0,2,1,0
Central African Republic,32,13,1999,1990.9,19,130,3,2,11,2,3,0,0,2,0,0
Nepal,31,6,1999,1990.9,25,131,1,3,2,4,0,1,1,2,0,0
Botswana,30,2,1999,1990.9,28,132,1,1,1,1,0,0,1,1,0,0
Azerbaijan,29,7,1999,1990.9,22,133,4,4,6,1,1,0,2,4,1,0
Chad,28,9,1999,1990.9,19,134,2,3,6,3,2,1,0,2,0,0
Armenia,27,5,1999,1990.9,22,135,3,6,2,3,0,1,2,5,1,0
Dominican Republic,27,2,1999,1990.9,25,136,1,2,2,0,1,0,0,1,0,1
Somalia,26,0,1999,1990.9,26,137,1,1,0,0,0,0,1,1,0,0
Burundi,24,6,1999,1990.9,18,138,4,4,5,1,2,0,1,3,1,1
Rwanda,19,9,1999,1990.9,10,139,5,3,5,4,2,1,0,0,3,2
British Virgin Islands,16,11,1999,1990.9,5,140,5,1,11,0,3,0,1,1,1,0
Maldives,16,6,1999,1990.9,10,141,1,3,2,4,1,1,0,1,0,1
Åland Islands,11,2,1999,1990.9,9,142,1,1,2,0,1,0,0,1,0,0
Liechtenstein,11,0,1999,1990.9,11,143,3,4,0,0,0,0,2,4,1,0
Gibraltar,10,2,1999,1990.9,8,144,1,1,1,1,0,0,1,1,0,0
Equatorial Guinea,6,5,1999,1990.9,1,145,1,4,4,1,1,0,0,4,0,0
São Tomé and Príncipe,5,2,1999,1990.9,3,146,1,4,2,0,1,0,0,4,0,0
Andorra,4,2,1999,1990.9,2,147,4,4,1,1,0,0,4,4,0,0
Bahamas,4,4,1999,1990.9,0,148,1,4,3,1,1,0,0,4,0,0
San Marino,4,0,1999,1990.9,4,149,1,4,0,0,0,0,1,4,0,0
Eritrea,3,3,1999,1990.9,0,150,2,5,1,2,1,0,0,5,1,0
Germany,1940,23,2000,2000,1917,1,6,6,19,4,4,1,0,4,2,1
Sweden,1575,9,2000,2000,1566,2,3,9,2,7,0,2,0,4,3,3
Hungary,1538,15,2000,2000,1523,3,6,3,7,8,1,3,1,0,4,0
Brazil,1355,32,2000,2000,1323,4,5,8,13,19,4,4,0,2,1,2
England,1339,11,2000,2000,1328,5,6,5,6,5,2,1,2,2,2,2
Argentina,1278,24,2000,2000,1254,6,5,7,10,14,4,5,0,1,1,1
Austria,1090,11,2000,2000,1079,7,4,3,8,3,1,1,1,1,2,1
Netherlands,1079,30,2000,2000,1049,8,11,3,22,8,7,2,1,0,3,1
Denmark,1059,11,2000,2000,1048,9,5,6,5,6,1,2,2,3,2,1
Scotland,1042,6,2000,2000,1036,10,2,5,0,6,0,3,2,0,0,2
South Korea,993,42,2000,2000,951,11,12,10,30,12,6,6,2,0,4,4
France,969,34,2000,2000,935,12,8,8,15,19,5,6,0,1,3,1
Czech Republic,955,21,2000,2000,934,13,5,7,12,9,3,3,2,3,0,1
Belgium,938,16,2000,2000,922,14,6,4,5,11,1,3,2,0,3,1
Italy,927,20,2000,2000,907,15,7,7,13,7,7,2,0,3,0,2
Norway,907,11,2000,2000,896,16,7,7,4,7,2,2,3,1,2,4
Poland,891,9,2000,2000,882,17,4,6,4,5,2,1,0,3,2,2
Uruguay,889,12,2000,2000,877,18,5,5,10,2,4,0,0,3,1,2
Mexico,818,41,2000,2000,777,19,14,7,36,5,9,3,3,3,2,1
Russia,803,10,2000,2000,793,20,4,3,7,3,3,2,0,1,1,0
Switzerland,802,17,2000,2000,785,21,4,5,9,8,1,1,1,1,2,3
Spain,782,19,2000,2000,763,22,6,7,9,10,3,3,3,1,0,3
Romania,711,23,2000,2000,688,23,8,9,11,12,5,2,1,6,2,1
Zambia,685,18,2000,2000,667,24,12,7,16,2,6,1,3,3,3,3
Bulgaria,667,17,2000,2000,650,25,7,4,11,6,4,1,3,1,0,2
Chile,654,23,2000,2000,631,26,10,7,18,5,5,1,4,6,1,0
Paraguay,654,20,2000,2000,634,27,6,8,15,5,6,1,0,3,0,4
Ghana,603,18,2000,2000,585,28,8,3,14,4,4,1,3,1,1,1
Wales,600,4,2000,2000,596,29,3,4,2,2,0,1,2,2,1,1
China,595,50,2000,2000,545,30,13,6,44,6,7,2,5,1,1,3
Finland,589,13,2000,2000,576,31,4,9,5,8,2,3,1,4,1,2
Trinidad and Tobago,575,41,2000,2000,534,32,12,12,33,8,9,3,2,5,1,4
Indonesia,543,21,2000,2000,522,33,5,8,11,10,4,2,0,5,1,1
Malaysia,523,45,2000,2000,478,34,16,6,34,11,11,2,3,3,2,1
Thailand,518,45,2000,2000,473,35,15,8,36,9,12,0,2,5,1,3
Costa Rica,505,23,2000,2000,482,36,9,5,19,4,6,0,2,3,1,2
Portugal,502,29,2000,2000,473,37,7,7,19,10,6,4,0,2,1,1
Northern Ireland,499,9,2000,2000,490,38,4,3,3,6,1,2,2,1,1,0
Ivory Coast,495,20,2000,2000,475,39,6,5,15,5,4,2,0,2,2,1
Ireland,483,17,2000,2000,466,40,6,4,11,6,4,0,2,0,0,4
Egypt,480,23,2000,2000,457,41,11,6,20,3,9,2,2,2,0,2
Nigeria,464,30,2000,2000,434,42,11,3,29,1,9,0,0,1,2,2
Peru,464,14,2000,2000,450,43,5,9,4,10,2,1,3,5,0,3
Japan,462,49,2000,2000,413,44,11,7,30,19,6,5,1,1,4,1
Saudi Arabia,455,28,2000,2000,427,45,7,9,18,10,5,3,1,3,1,3
Kenya,453,17,2000,2000,436,46,10,6,12,5,3,0,3,5,4,1
Tunisia,451,33,2000,2000,418,47,9,9,23,10,6,2,0,3,3,4
Iraq,449,22,2000,2000,427,48,5,10,11,11,4,3,0,4,1,3
Uganda,440,42,2000,2000,398,49,11,6,37,5,8,2,0,3,3,1
Kuwait,433,45,2000,2000,388,50,9,6,43,2,6,1,1,3,2,2
Malawi,432,17,2000,2000,415,51,6,8,7,10,2,1,2,4,2,3
Cameroon,417,26,2000,2000,391,52,7,6,17,9,6,1,1,0,0,5
USA,404,34,2000,2000,370,53,12,5,26,8,7,2,0,2,5,1
Morocco,395,10,2000,2000,385,54,8,5,9,1,6,1,1,2,1,2
Greece,394,12,2000,2000,382,55,5,5,8,4,3,1,1,3,1,1
Algeria,388,26,2000,2000,362,56,9,8,19,7,5,0,2,3,2,5
Guinea,382,25,2000,2000,357,57,8,5,17,8,7,1,0,3,1,1
Iran,371,63,2000,2000,308,58,14,12,42,21,10,5,1,3,3,4
Senegal,365,15,2000,2000,350,59,7,11,3,12,1,1,0,5,6,5
Democratic Republic of the Congo,364,20,2000,2000,344,60,6,6,14,6,3,1,0,3,3,2
Singapore,359,15,2000,2000,344,61,8,5,14,1,6,1,2,3,0,1
Turkey,359,7,2000,2000,352,62,5,4,3,4,1,2,4,0,0,2
Honduras,356,48,2000,2000,308,63,8,10,26,22,7,6,1,4,0,0
Colombia,355,16,2000,2000,339,64,7,9,8,8,4,3,2,3,1,3
Australia,353,39,2000,2000,314,65,10,5,26,13,5,3,1,2,4,0
Mali,352,13,2000,2000,339,66,4,4,10,3,3,0,0,3,1,1
Israel,342,10,2000,2000,332,67,3,5,7,3,2,0,0,5,1,0
Jamaica,341,23,2000,2000,318,68,9,8,12,11,4,3,4,4,1,1
Myanmar,335,13,2000,2000,322,69,5,5,9,4,3,1,2,4,0,0
El Salvador,328,23,2000,2000,305,70,9,6,17,6,4,2,4,4,1,0
New Zealand,327,9,2000,2000,318,71,5,5,6,3,3,1,1,3,1,1
Guatemala,323,33,2000,2000,290,72,10,10,21,12,5,4,1,4,4,2
Ecuador,311,18,2000,2000,293,73,7,7,13,5,5,1,1,5,1,1
Congo,303,14,2000,2000,289,74,2,9,3,11,1,4,1,4,0,1
Bolivia,301,14,2000,2000,287,75,7,8,12,2,3,0,1,7,3,1
United Arab Emirates,293,11,2000,2000,282,76,5,5,5,6,2,2,0,2,3,1
Zimbabwe,293,21,2000,2000,272,77,6,7,14,7,5,4,1,3,0,0
Haiti,288,32,2000,2000,256,78,6,11,16,16,2,4,2,6,2,1
Tanzania,275,9,2000,2000,266,79,4,3,5,4,1,0,2,3,1,0
Curaçao,270,1,2000,2000,269,80,1,1,1,0,0,0,0,1,1,0
Iceland,270,13,2000,2000,257,81,5,4,9,4,3,2,1,2,1,0
Qatar,264,30,2000,2000,234,82,12,7,20,10,5,2,3,3,4,2
Latvia,262,4,2000,2000,258,83,5,3,2,2,1,1,4,2,0,0
Ethiopia,250,15,2000,2000,235,84,7,4,11,4,5,1,1,2,1,1
Estonia,248,14,2000,2000,234,85,6,5,8,6,4,2,2,2,0,1
India,237,2,2000,2000,235,86,1,3,0,2,0,1,1,1,0,1
Togo,227,14,2000,2000,213,87,4,10,9,5,4,2,0,5,0,3
Hong Kong,223,4,2000,2000,219,88,4,2,2,2,1,1,2,0,1,1
Suriname,211,1,2000,2000,210,89,2,2,1,0,1,0,0,2,1,0
Canada,208,14,2000,2000,194,90,8,9,6,8,4,4,1,2,3,3
Sudan,205,10,2000,2000,195,91,4,5,8,2,3,0,1,5,0,0
Burkina Faso,199,19,2000,2000,180,92,7,8,11,8,3,1,2,4,2,3
Gabon,195,14,2000,2000,181,93,5,6,9,5,3,0,2,4,0,2
Lithuania,194,8,2000,2000,186,94,3,5,3,5,1,1,2,4,0,0
Syria,184,15,2000,2000,169,95,8,11,8,7,6,2,1,5,1,4
Cuba,175,14,2000,2000,161,96,7,6,11,3,3,0,2,1,2,5
Libya,175,11,2000,2000,164,97,4,4,7,4,3,0,1,3,0,1
Panama,166,20,2000,2000,146,98,7,12,11,9,4,2,1,9,2,1
Mozambique,154,5,2000,2000,149,99,2,6,3,2,2,0,0,4,0,2
Oman,151,14,2000,2000,137,100,6,4,11,3,3,1,3,3,0,0
Angola,149,19,2000,2000,130,101,4,7,15,4,3,2,0,2,1,3
New Caledonia,149,15,2000,2000,134,102,4,2,14,1,4,0,0,2,0,0
Croatia,148,5,2000,2000,143,103,4,3,2,3,0,1,1,0,3,2
Cyprus,148,16,2000,2000,132,104,6,3,13,3,4,1,1,1,1,1
Mauritius,148,8,2000,2000,140,105,2,7,4,4,1,1,1,5,0,1
Bahrain,144,9,2000,2000,135,106,8,4,8,1,4,0,3,4,1,0
Sierra Leone,123,8,2000,2000,115,107,2,6,6,2,2,0,0,5,0,1
South Africa,121,26,2000,2000,95,108,10,9,15,11,6,5,1,4,3,0
Serbia,120,19,2000,2000,101,109,3,10,7,12,1,5,1,2,1,3
Malta,118,7,2000,2000,111,110,8,5,7,0,2,0,4,5,2,0
Barbados,112,20,2000,2000,92,111,9,7,13,7,3,2,2,4,4,1
Slovakia,107,13,2000,2000,94,112,4,9,4,9,1,4,0,2,3,3
Liberia,106,8,2000,2000,98,113,3,3,6,2,2,1,0,2,1,0
Madagascar,106,9,2000,2000,97,114,5,4,7,2,3,1,0,3,2,0
Jordan,103,23,2000,2000,80,115,12,8,7,16,2,3,3,1,7,4
Luxembourg,103,3,2000,2000,100,116,5,1,3,0,0,0,4,1,1,0
Uzbekistan,102,15,2000,2000,87,117,2,6,11,4,2,0,0,5,0,1
Grenada,100,4,2000,2000,96,118,1,1,2,2,0,0,1,0,0,1
Lebanon,99,18,2000,2000,81,119,11,4,14,4,2,1,4,0,5,3
Albania,98,11,2000,2000,87,120,5,3,9,2,4,1,0,2,1,0
Gambia,96,4,2000,2000,92,121,5,3,3,1,0,0,1,2,4,1
Antigua and Barbuda,95,8,2000,2000,87,122,3,5,3,5,1,0,1,2,1,3
Venezuela,93,15,2000,2000,78,123,7,7,8,7,2,1,4,6,1,0
Slovenia,91,20,2000,2000,71,124,4,7,5,15,1,3,1,1,2,3
St. Kitts and Nevis,89,14,2000,2000,75,125,3,1,14,0,2,0,1,1,0,0
Benin,88,6,2000,2000,82,126,3,2,4,2,1,0,1,2,1,0
Niger,87,0,2000,2000,87,127,1,1,0,0,0,0,1,1,0,0
Dominica,84,5,2000,2000,79,128,2,2,3,2,1,0,1,2,0,0
Cambodia,83,6,2000,2000,77,129,2,4,3,3,1,0,1,3,0,1
Namibia,82,18,2000,2000,64,130,4,5,13,5,3,1,0,3,1,1
Georgia,79,9,2000,2000,70,131,1,8,2,7,1,1,0,3,0,4
Ukraine,76,6,2000,2000,70,132,1,4,1,5,0,3,1,1,0,0
Macedonia,73,9,2000,2000,64,133,4,5,5,4,2,1,2,3,0,1
Vietnam,72,30,2000,2000,42,134,8,2,19,11,3,2,3,0,2,0
Guinea-Bissau,69,4,2000,2000,65,135,2,3,1,3,1,0,0,3,1,0
Papua New Guinea,69,4,2000,2000,65,136,1,3,1,3,0,0,1,3,0,0
Solomon Islands,66,17,2000,2000,49,137,4,4,11,6,3,1,1,2,0,1
Aruba,65,7,2000,2000,58,138,2,2,5,2,1,0,1,1,0,1
Bermuda,65,15,2000,2000,50,139,3,2,10,5,1,1,1,0,1,1
Bangladesh,63,2,2000,2000,61,140,3,1,1,1,0,0,2,0,1,1
St. Lucia,62,5,2000,2000,57,141,1,3,1,4,1,2,0,1,0,0
Belarus,57,7,2000,2000,50,142,2,5,4,3,2,1,0,4,0,0
Lesotho,57,12,2000,2000,45,143,8,10,7,5,3,1,2,6,3,3
Swaziland,56,5,2000,2000,51,144,5,5,4,1,1,0,2,5,2,0
Faroe Islands,55,6,2000,2000,49,145,4,2,4,2,0,1,3,1,1,0
Turkmenistan,54,15,2000,2000,39,146,1,4,5,10,1,2,0,2,0,0
Vanuatu,54,15,2000,2000,39,147,2,7,7,8,1,1,1,6,0,0
Mauritania,50,4,2000,2000,46,148,1,6,1,3,0,0,1,2,0,4
Moldova,48,5,2000,2000,43,149,5,3,3,2,2,1,2,2,1,0
Pakistan,47,0,2000,2000,47,150,2,2,0,0,0,0,2,2,0,0
Yemen,46,14,2000,2000,32,151,2,4,11,3,1,1,1,3,0,0
Kazakhstan,45,12,2000,2000,33,152,3,6,5,7,2,3,1,3,0,0
Tajikistan,43,16,2000,2000,27,153,1,1,16,0,1,0,0,1,0,0
Cayman Islands,42,3,2000,2000,39,154,5,1,3,0,1,0,2,1,2,0
Palestine,40,6,2000,2000,34,155,3,4,4,2,1,0,1,4,1,0
Botswana,38,8,2000,2000,30,156,6,3,8,0,4,0,1,2,1,1
Armenia,36,9,2000,2000,27,157,3,5,4,5,1,0,1,3,1,2
Burundi,36,12,2000,2000,24,158,2,7,1,11,1,3,0,4,1,0
Cape Verde,36,8,2000,2000,28,159,7,1,8,0,3,0,0,1,4,0
Rwanda,35,16,2000,2000,19,160,4,8,7,9,3,3,0,3,1,2
Central African Republic,34,2,2000,2000,32,161,2,2,1,1,0,0,1,2,1,0
Dominican Republic,34,7,2000,2000,27,162,3,2,4,3,2,1,1,1,0,0
Nepal,34,3,2000,2000,31,163,2,2,3,0,1,0,1,2,0,0
Azerbaijan,31,2,2000,2000,29,164,4,5,1,1,0,0,3,4,1,1
Chad,29,1,2000,2000,28,165,1,2,0,1,0,0,1,1,0,1
British Virgin Islands,28,12,2000,2000,16,166,5,2,12,0,1,0,3,2,1,0
Laos,27,2,2000,2000,25,167,3,4,2,0,1,0,2,4,0,0
Somalia,27,1,2000,2000,26,168,1,4,1,0,0,0,1,3,0,1
Nicaragua,25,0,2000,2000,25,169,2,3,0,0,0,0,2,3,0,0
Philippines,24,2,2000,2000,22,170,1,5,2,0,1,0,0,5,0,0
Maldives,23,7,2000,2000,16,171,5,7,4,3,1,0,1,7,3,0
Puerto Rico,23,4,2000,2000,19,172,1,1,2,2,0,0,0,1,1,0
Kyrgyzstan,22,0,2000,2000,22,173,1,3,0,0,0,0,1,3,0,0
Tonga,16,3,2000,2000,13,174,1,1,1,2,0,1,1,0,0,0
Liechtenstein,13,2,2000,2000,11,175,2,2,0,2,0,0,2,2,0,0
Djibouti,11,7,2000,2000,4,176,4,4,4,3,0,0,2,4,2,0
Seychelles,11,1,2000,2000,10,177,2,1,1,0,0,0,1,1,1,0
Andorra,10,6,2000,2000,4,178,4,4,5,1,1,0,2,3,1,1
Anguilla,9,6,2000,2000,3,179,1,3,1,5,0,1,1,2,0,0
Bahamas,9,5,2000,2000,4,180,2,2,2,3,1,1,1,1,0,0
Equatorial Guinea,9,3,2000,2000,6,181,2,2,1,2,0,0,2,2,0,0
São Tomé and Príncipe,8,3,2000,2000,5,182,1,2,2,1,1,0,0,2,0,0
Eritrea,7,4,2000,2000,3,183,4,2,3,1,1,0,1,2,2,0
Belize,5,2,2000,2000,3,184,2,2,2,0,0,0,2,1,0,1
Montserrat,5,1,2000,2000,4,185,1,1,1,0,0,0,1,1,0,0
Bhutan,2,2,2000,2000,0,186,1,3,0,2,0,0,1,3,0,0
Germany,1963,23,2001,2000.1,1940,1,5,6,9,14,3,3,1,1,1,2
Sweden,1611,36,2001,2000.1,1575,2,8,9,15,21,5,7,1,0,2,2
Hungary,1552,14,2001,2000.1,1538,3,6,4,12,2,2,0,2,3,2,1
Brazil,1383,28,2001,2000.1,1355,4,10,10,20,8,7,1,2,6,1,3
England,1363,24,2001,2000.1,1339,5,7,3,14,10,4,3,1,0,2,0
Argentina,1300,22,2001,2000.1,1278,6,4,5,12,10,4,2,0,0,0,3
Netherlands,1106,27,2001,2000.1,1079,7,4,6,13,14,3,3,0,1,1,2
Austria,1096,6,2001,2000.1,1090,8,4,4,5,1,2,0,2,3,0,1
Denmark,1081,22,2001,2000.1,1059,9,6,4,15,7,4,2,0,1,2,1
Scotland,1051,9,2001,2000.1,1042,10,4,2,8,1,2,0,0,1,2,1
South Korea,1015,22,2001,2000.1,993,11,12,5,14,8,5,3,3,1,4,1
France,999,30,2001,2000.1,969,12,7,6,21,9,7,2,0,3,0,1
Czech Republic,977,22,2001,2000.1,955,13,7,5,18,4,4,1,1,3,2,1
Belgium,963,25,2001,2000.1,938,14,4,6,16,9,4,2,0,2,0,2
Italy,940,13,2001,2000.1,927,15,5,4,8,5,4,2,1,0,0,2
Norway,928,21,2001,2000.1,907,16,5,6,9,12,2,3,1,2,2,1
Poland,912,21,2001,2000.1,891,17,5,6,9,12,2,3,0,1,3,2
Uruguay,908,19,2001,2000.1,889,18,8,9,11,8,3,4,1,4,4,1
Mexico,855,37,2001,2000.1,818,19,13,14,29,8,8,3,4,8,1,3
Russia,823,20,2001,2000.1,803,20,5,6,7,13,2,4,0,1,3,1
Switzerland,815,13,2001,2000.1,802,21,5,5,6,7,1,3,4,1,0,1
Spain,798,16,2001,2000.1,782,22,5,3,13,3,5,1,0,1,0,1
Romania,732,21,2001,2000.1,711,23,8,7,9,12,3,4,2,2,3,1
Zambia,705,20,2001,2000.1,685,24,6,11,7,13,1,4,0,6,5,1
Bulgaria,683,16,2001,2000.1,667,25,4,8,7,9,3,4,1,2,0,2
Chile,672,18,2001,2000.1,654,26,10,8,11,7,5,1,3,7,2,0
Paraguay,672,18,2001,2000.1,654,27,6,8,10,8,3,1,1,5,2,2
China,645,50,2001,2000.1,595,28,12,10,33,17,8,6,1,3,3,1
Ghana,616,13,2001,2000.1,603,29,4,8,5,8,2,2,1,3,1,3
Trinidad and Tobago,614,39,2001,2000.1,575,30,12,12,25,14,6,5,4,5,2,2
Finland,613,24,2001,2000.1,589,31,3,10,11,13,2,5,0,2,1,3
Wales,608,8,2001,2000.1,600,32,4,3,3,5,1,0,1,1,2,2
Thailand,564,46,2001,2000.1,518,33,16,7,36,10,8,2,4,3,4,2
Indonesia,559,16,2001,2000.1,543,34,3,3,11,5,2,2,1,1,0,0
Costa Rica,542,37,2001,2000.1,505,35,9,11,20,17,5,7,0,3,4,1
Portugal,537,35,2001,2000.1,502,36,6,4,24,11,5,2,0,1,1,1
Malaysia,536,13,2001,2000.1,523,37,3,8,6,7,1,2,2,5,0,1
Ivory Coast,521,26,2001,2000.1,495,38,5,7,13,13,3,4,1,0,1,3
Egypt,517,37,2001,2000.1,480,39,10,9,30,7,7,0,1,3,2,6
Saudi Arabia,516,61,2001,2000.1,455,40,16,7,44,17,10,6,3,1,3,0
Northern Ireland,508,9,2001,2000.1,499,41,4,4,3,6,1,1,3,2,0,1
Ireland,505,22,2001,2000.1,483,42,6,4,13,9,4,3,0,1,2,0
Iraq,488,39,2001,2000.1,449,43,8,10,29,10,5,1,2,4,1,5
Nigeria,486,22,2001,2000.1,464,44,5,8,10,12,5,2,0,2,0,4
Tunisia,480,29,2001,2000.1,451,45,6,5,21,8,4,3,1,1,1,1
Japan,477,15,2001,2000.1,462,46,11,3,15,0,6,0,2,3,3,0
Peru,475,11,2001,2000.1,464,47,6,7,9,2,2,1,2,4,2,2
Kenya,469,16,2001,2000.1,453,48,10,3,14,2,6,0,1,1,3,2
Kuwait,456,23,2001,2000.1,433,49,9,6,12,11,4,2,2,2,3,2
Uganda,455,15,2001,2000.1,440,50,5,6,11,4,1,1,3,4,1,1
Malawi,440,8,2001,2000.1,432,51,5,5,4,4,1,1,3,3,1,1
Australia,433,80,2001,2000.1,353,52,9,7,74,6,8,2,0,5,1,0
Cameroon,430,13,2001,2000.1,417,53,4,8,6,7,4,2,0,3,0,3
USA,418,14,2001,2000.1,404,54,9,6,12,2,5,1,3,3,1,2
Morocco,411,16,2001,2000.1,395,55,7,9,8,8,4,3,1,3,2,3
Greece,410,16,2001,2000.1,394,56,6,4,11,5,2,0,3,1,1,3
Algeria,408,20,2001,2000.1,388,57,8,7,12,8,4,2,1,5,3,0
Iran,400,29,2001,2000.1,371,58,9,9,16,13,7,3,1,4,1,2
Honduras,396,40,2001,2000.1,356,59,14,8,26,14,6,3,5,2,3,3
Senegal,389,24,2001,2000.1,365,60,7,7,15,9,6,3,1,1,0,3
Colombia,387,32,2001,2000.1,355,61,12,6,21,11,10,3,1,1,1,2
Guinea,384,2,2001,2000.1,382,62,2,1,1,1,0,1,0,0,2,0
Turkey,380,21,2001,2000.1,359,63,6,6,13,8,2,4,2,0,2,2
Democratic Republic of the Congo,375,11,2001,2000.1,364,64,6,6,6,5,3,1,3,2,0,3
Mali,369,17,2001,2000.1,352,65,11,3,15,2,6,1,3,2,2,0
Singapore,366,7,2001,2000.1,359,66,7,3,6,1,1,0,4,2,2,1
Israel,356,14,2001,2000.1,342,67,4,4,5,9,2,2,0,2,2,0
Jamaica,356,15,2001,2000.1,341,68,8,11,7,8,2,3,2,6,4,2
New Zealand,342,15,2001,2000.1,327,69,4,2,14,1,3,0,1,2,0,0
El Salvador,338,10,2001,2000.1,328,70,6,5,6,4,2,0,1,2,3,3
Guatemala,338,15,2001,2000.1,323,71,4,5,9,6,2,0,0,2,2,3
United Arab Emirates,332,39,2001,2000.1,293,72,12,11,18,21,4,4,5,6,3,1
Ecuador,329,18,2001,2000.1,311,73,6,8,9,9,3,3,2,1,1,4
Bolivia,317,16,2001,2000.1,301,74,6,5,12,4,2,0,3,3,1,2
Zimbabwe,310,17,2001,2000.1,293,75,5,8,7,10,3,5,2,2,0,1
Congo,309,6,2001,2000.1,303,76,6,4,5,1,1,0,2,4,3,0
Haiti,309,21,2001,2000.1,288,77,8,4,19,2,4,1,0,2,4,1
Qatar,302,38,2001,2000.1,264,78,13,14,20,18,5,8,1,4,7,2
Tanzania,287,12,2001,2000.1,275,79,3,2,9,3,2,2,0,0,1,0
Iceland,286,16,2001,2000.1,270,80,4,6,8,8,2,2,0,4,2,0
Latvia,276,14,2001,2000.1,262,81,6,4,9,5,2,1,3,3,1,0
Martinique,268,24,2001,2000.1,244,82,7,5,19,5,5,1,1,2,1,2
Estonia,263,15,2001,2000.1,248,83,6,7,7,8,0,0,3,4,3,3
Ethiopia,256,6,2001,2000.1,250,84,2,2,3,3,0,2,1,0,1,0
India,249,12,2001,2000.1,237,85,5,3,8,4,2,1,2,1,1,1
Togo,245,18,2001,2000.1,227,86,6,8,8,10,3,2,1,2,2,4
Hong Kong,228,5,2001,2000.1,223,87,5,3,3,2,1,0,3,3,1,0
Syria,228,44,2001,2000.1,184,88,5,8,40,4,4,0,0,5,1,3
Suriname,225,14,2001,2000.1,211,89,4,2,10,4,2,0,1,1,1,1
Burkina Faso,214,15,2001,2000.1,199,90,7,9,9,6,3,1,3,6,1,2
Oman,214,63,2001,2000.1,151,91,21,9,53,10,13,1,5,4,3,4
Sudan,214,9,2001,2000.1,205,92,5,7,5,4,3,2,1,4,1,1
Canada,210,2,2001,2000.1,208,93,2,4,1,1,1,0,0,4,1,0
Lithuania,206,12,2001,2000.1,194,94,4,6,3,9,0,2,3,3,1,1
Gabon,201,6,2001,2000.1,195,95,3,2,4,2,1,1,0,1,2,0
Cuba,191,16,2001,2000.1,175,96,5,8,9,7,4,1,0,4,1,3
Libya,184,9,2001,2000.1,175,97,5,6,8,1,1,0,2,6,2,0
Panama,184,18,2001,2000.1,166,98,7,8,12,6,3,1,1,4,3,3
Bahrain,170,26,2001,2000.1,144,99,11,12,13,13,5,4,4,3,2,5
Angola,169,20,2001,2000.1,149,100,8,8,13,7,6,0,0,4,2,4
Croatia,168,20,2001,2000.1,148,101,5,6,12,8,4,2,0,1,1,3
Cyprus,160,12,2001,2000.1,148,102,5,5,8,4,1,1,3,3,1,1
Mozambique,158,4,2001,2000.1,154,103,2,2,1,3,1,1,1,0,0,1
Mauritius,149,1,2001,2000.1,148,104,1,3,1,0,1,0,0,2,0,1
Serbia,147,27,2001,2000.1,120,105,7,7,13,14,4,3,1,2,2,2
Fiji,144,34,2001,2000.1,110,106,4,3,20,14,3,2,1,1,0,0
Uzbekistan,142,40,2001,2000.1,102,107,8,12,23,17,6,4,1,6,1,2
Guadeloupe,138,3,2001,2000.1,135,108,1,2,2,1,0,0,1,2,0,0
South Africa,137,16,2001,2000.1,121,109,5,7,9,7,5,2,0,3,0,2
Lebanon,131,32,2001,2000.1,99,110,7,3,17,15,3,2,1,0,3,1
Liberia,128,22,2001,2000.1,106,111,5,8,10,12,3,3,1,5,1,0
Sierra Leone,126,3,2001,2000.1,123,112,5,2,3,0,1,0,2,2,2,0
Grenada,124,24,2001,2000.1,100,113,6,3,19,5,4,0,2,3,0,0
Malta,124,6,2001,2000.1,118,114,6,3,3,3,1,0,5,3,0,0
Slovakia,124,17,2001,2000.1,107,115,4,7,10,7,2,1,2,3,0,3
Barbados,123,11,2001,2000.1,112,116,3,3,8,3,2,0,1,2,0,1
Jordan,117,14,2001,2000.1,103,117,5,4,9,5,1,2,2,1,2,1
Madagascar,112,6,2001,2000.1,106,118,6,5,4,2,2,0,4,4,0,1
St. Kitts and Nevis,108,19,2001,2000.1,89,119,6,3,11,8,4,1,0,1,2,1
Slovenia,107,16,2001,2000.1,91,120,7,5,12,4,4,1,1,1,2,3
Luxembourg,106,3,2001,2000.1,103,121,5,4,1,2,0,0,5,4,0,0
Venezuela,105,12,2001,2000.1,93,122,4,7,10,2,3,1,0,6,1,0
Albania,102,4,2001,2000.1,98,123,3,4,1,3,0,1,3,3,0,0
Gambia,99,3,2001,2000.1,96,124,2,3,0,3,0,1,1,0,1,2
Benin,94,6,2001,2000.1,88,125,4,1,6,0,1,0,2,0,1,1
Georgia,94,15,2001,2000.1,79,126,7,3,10,5,4,1,2,1,1,1
Namibia,92,10,2001,2000.1,82,127,5,9,3,7,0,1,3,7,2,1
Dominica,91,7,2001,2000.1,84,128,3,3,3,4,0,0,2,3,1,0
Ukraine,90,14,2001,2000.1,76,129,5,8,5,9,1,2,0,3,4,3
Cambodia,85,2,2001,2000.1,83,130,3,4,1,1,0,0,2,4,1,0
Macedonia,83,10,2001,2000.1,73,131,6,7,5,5,0,0,4,4,2,3
Solomon Islands,83,17,2001,2000.1,66,132,1,2,9,8,1,1,0,1,0,0
Vietnam,81,9,2001,2000.1,72,133,2,4,4,5,1,2,0,2,1,0
Guinea-Bissau,78,9,2001,2000.1,69,134,1,3,1,8,1,1,0,2,0,0
St. Lucia,76,14,2001,2000.1,62,135,1,8,1,13,0,3,0,4,1,1
Bangladesh,72,9,2001,2000.1,63,136,4,4,6,3,1,1,2,2,1,1
Swaziland,67,11,2001,2000.1,56,137,4,6,5,6,2,1,0,4,2,1
Lesotho,66,9,2001,2000.1,57,138,6,6,4,5,2,1,2,4,2,1
Kazakhstan,65,20,2001,2000.1,45,139,4,3,13,7,3,1,0,0,1,2
Belarus,64,7,2001,2000.1,57,140,3,4,6,1,2,0,1,1,0,3
Vanuatu,64,10,2001,2000.1,54,141,1,2,2,8,0,1,1,1,0,0
Sri Lanka,63,9,2001,2000.1,54,142,3,4,4,5,2,0,1,3,0,1
Turkmenistan,61,7,2001,2000.1,54,143,3,2,5,2,2,1,1,1,0,0
Yemen,60,14,2001,2000.1,46,144,3,3,6,8,2,1,0,1,1,1
Faroe Islands,58,3,2001,2000.1,55,145,4,5,1,2,1,1,3,3,0,1
Moldova,54,6,2001,2000.1,48,146,4,6,2,4,1,0,2,4,1,2
Mauritania,52,2,2001,2000.1,50,147,1,3,0,2,0,0,1,3,0,0
Pakistan,52,5,2001,2000.1,47,148,2,4,4,1,0,0,1,4,1,0
Palestine,48,8,2001,2000.1,40,149,3,3,3,5,2,0,1,2,0,1
Nepal,47,13,2001,2000.1,34,150,2,4,4,9,1,1,1,3,0,0
Burundi,46,10,2001,2000.1,36,151,4,4,4,6,1,1,2,2,1,1
Cayman Islands,45,3,2001,2000.1,42,152,2,1,2,1,0,0,1,0,1,1
Jersey,43,3,2001,2000.1,40,153,1,1,2,1,1,0,0,1,0,0
Armenia,42,6,2001,2000.1,36,154,5,3,6,0,1,0,1,2,3,1
Cape Verde,38,2,2001,2000.1,36,155,1,1,1,1,0,1,0,0,1,0
Azerbaijan,36,5,2001,2000.1,31,156,4,5,4,1,1,0,1,5,2,0
British Virgin Islands,33,5,2001,2000.1,28,157,1,4,0,5,0,1,0,1,1,2
Maldives,31,8,2001,2000.1,23,158,3,5,6,2,1,0,2,4,0,1
Laos,30,3,2001,2000.1,27,159,1,5,2,1,1,0,0,4,0,1
Kyrgyzstan,26,4,2001,2000.1,22,160,3,4,2,2,0,1,2,3,1,0
Philippines,26,2,2001,2000.1,24,161,1,6,1,1,0,0,0,6,1,0
Puerto Rico,24,1,2001,2000.1,23,162,1,2,1,0,0,0,1,1,0,1
Tonga,23,7,2001,2000.1,16,163,1,3,1,6,0,2,1,1,0,0
Macau,19,2,2001,2000.1,17,164,2,4,1,1,0,0,2,4,0,0
Samoa,18,9,2001,2000.1,9,165,2,2,1,8,0,1,2,1,0,0
Belize,15,10,2001,2000.1,5,166,3,2,7,3,3,0,0,1,0,1
Anguilla,14,5,2001,2000.1,9,167,1,1,4,1,1,0,0,1,0,0
St. Martin,14,9,2001,2000.1,5,168,2,3,6,3,2,1,0,2,0,0
Liechtenstein,13,0,2001,2000.1,13,169,3,2,0,0,0,0,3,2,0,0
Andorra,12,2,2001,2000.1,10,170,3,3,1,1,0,0,3,3,0,0
Cook Islands,10,2,2001,2000.1,8,171,1,2,1,1,0,0,1,2,0,0
Brunei,8,0,2001,2000.1,8,172,3,3,0,0,0,0,3,3,0,0
Eritrea,8,1,2001,2000.1,7,173,1,3,0,1,0,0,0,3,1,0
San Marino,7,3,2001,2000.1,4,174,2,4,1,2,0,0,2,3,0,1
Mongolia,2,2,2001,2000.1,0,175,2,4,0,2,0,0,2,3,0,1
American Samoa,0,0,2001,2000.1,0,176,2,2,0,0,0,0,2,2,0,0
Germany,2008,45,2002,2000.2,1963,1,12,5,38,7,8,3,3,1,1,1
Sweden,1628,17,2002,2000.2,1611,2,7,7,9,8,1,0,3,0,3,7
Hungary,1565,13,2002,2000.2,1552,3,5,5,7,6,1,2,2,2,2,1
Brazil,1423,40,2002,2000.2,1383,4,8,7,22,18,7,6,1,0,0,1
England,1383,20,2002,2000.2,1363,5,6,7,10,10,1,3,2,0,3,4
Argentina,1308,8,2002,2000.2,1300,6,3,4,3,5,1,2,1,0,1,2
Netherlands,1120,14,2002,2000.2,1106,7,3,4,5,9,2,4,0,0,1,0
Austria,1106,10,2002,2000.2,1096,8,5,3,4,6,2,1,2,2,1,0
Denmark,1101,20,2002,2000.2,1081,9,8,5,14,6,6,3,1,1,1,1
Scotland,1060,9,2002,2000.2,1051,10,4,5,4,5,1,1,3,3,0,1
South Korea,1040,25,2002,2000.2,1015,11,15,7,19,6,5,1,4,4,6,2
France,1025,26,2002,2000.2,999,12,8,5,16,10,4,3,2,1,2,1
Czech Republic,1000,23,2002,2000.2,977,13,6,4,17,6,5,2,0,0,1,2
Belgium,977,14,2002,2000.2,963,14,6,7,6,8,3,3,1,1,2,3
Italy,954,14,2002,2000.2,940,15,7,6,7,7,2,2,2,3,3,1
Norway,936,8,2002,2000.2,928,16,5,4,6,2,1,2,1,1,3,1
Poland,928,16,2002,2000.2,912,17,7,6,8,8,3,3,3,3,1,0
Uruguay,922,14,2002,2000.2,908,18,2,8,3,11,1,2,1,3,0,3
Mexico,872,17,2002,2000.2,855,19,10,2,15,2,6,2,2,0,2,0
Russia,839,16,2002,2000.2,823,20,6,5,13,3,3,0,0,4,3,1
Switzerland,830,15,2002,2000.2,815,21,4,4,10,5,3,1,1,0,0,3
Spain,821,23,2002,2000.2,798,22,7,6,12,11,4,3,0,1,3,2
Romania,746,14,2002,2000.2,732,23,4,3,4,10,1,2,3,1,0,0
Zambia,714,9,2002,2000.2,705,24,3,8,4,5,1,1,0,4,2,3
Bulgaria,691,8,2002,2000.2,683,25,4,4,6,2,2,1,1,2,1,1
Paraguay,685,13,2002,2000.2,672,26,2,9,4,9,0,3,0,3,2,3
Chile,675,3,2002,2000.2,672,27,1,1,3,0,1,0,0,1,0,0
China,650,5,2002,2000.2,645,28,6,4,3,2,1,0,3,2,2,2
Finland,628,15,2002,2000.2,613,29,6,5,8,7,3,2,3,2,0,1
Ghana,625,9,2002,2000.2,616,30,3,9,6,3,2,1,1,5,0,3
Trinidad and Tobago,621,7,2002,2000.2,614,31,3,4,2,5,1,1,2,1,0,2
Wales,617,9,2002,2000.2,608,32,4,3,4,5,2,2,0,0,2,1
Thailand,584,20,2002,2000.2,564,33,5,3,13,7,4,1,1,0,0,2
Indonesia,582,23,2002,2000.2,559,34,6,1,22,1,3,0,0,0,3,1
Costa Rica,560,18,2002,2000.2,542,35,7,7,11,7,2,2,2,3,3,2
Portugal,555,18,2002,2000.2,537,36,5,6,9,9,2,2,1,2,2,2
Malaysia,552,16,2002,2000.2,536,37,4,7,7,9,1,2,2,3,1,2
Saudi Arabia,538,22,2002,2000.2,516,38,13,5,17,5,8,1,3,3,2,1
Egypt,537,20,2002,2000.2,517,39,11,4,17,3,6,1,3,1,2,2
Ivory Coast,528,7,2002,2000.2,521,40,3,3,6,1,1,0,0,2,2,1
Ireland,525,20,2002,2000.2,505,41,6,6,10,10,3,2,2,1,1,3
Northern Ireland,509,1,2002,2000.2,508,42,4,2,1,0,0,0,2,1,2,1
Nigeria,508,22,2002,2000.2,486,43,7,13,7,15,2,7,1,2,4,4
Iraq,506,18,2002,2000.2,488,44,4,6,6,12,3,4,0,1,1,1
Kenya,493,24,2002,2000.2,469,45,7,8,11,13,3,4,0,2,4,2
Japan,492,15,2002,2000.2,477,46,11,2,13,2,4,1,2,1,5,0
Tunisia,484,4,2002,2000.2,480,47,6,8,2,2,0,0,1,5,5,3
Uganda,474,19,2002,2000.2,455,48,5,10,9,10,3,3,1,3,1,4
Kuwait,467,11,2002,2000.2,456,49,8,2,10,1,2,0,3,1,3,1
Australia,454,21,2002,2000.2,433,50,3,1,21,0,3,0,0,1,0,0
Malawi,454,14,2002,2000.2,440,51,9,1,14,0,7,0,1,1,1,0
USA,451,33,2002,2000.2,418,52,12,7,26,7,10,1,1,5,1,1
Cameroon,450,20,2002,2000.2,430,53,7,8,9,11,5,3,1,1,1,4
Morocco,434,23,2002,2000.2,411,54,5,6,14,9,3,4,1,1,1,1
Algeria,421,13,2002,2000.2,408,55,5,4,10,3,2,1,1,1,2,2
Greece,418,8,2002,2000.2,410,56,6,2,7,1,2,1,1,1,3,0
Iran,413,13,2002,2000.2,400,57,5,5,7,6,2,2,1,1,2,2
Senegal,411,22,2002,2000.2,389,58,8,9,10,12,3,6,1,1,4,2
Turkey,406,26,2002,2000.2,380,59,6,10,16,10,5,4,1,3,0,3
Honduras,405,9,2002,2000.2,396,60,1,3,1,8,1,1,0,1,0,1
Mali,389,20,2002,2000.2,369,61,10,4,13,7,5,2,2,1,3,1
Guinea,388,4,2002,2000.2,384,62,1,3,3,1,1,0,0,3,0,0
Democratic Republic of the Congo,386,11,2002,2000.2,375,63,3,5,5,6,2,1,0,3,1,1
Singapore,378,12,2002,2000.2,366,64,7,5,9,3,3,1,2,4,2,0
Jamaica,371,15,2002,2000.2,356,65,2,9,2,13,1,4,1,1,0,4
New Zealand,363,21,2002,2000.2,342,66,4,2,19,2,4,0,0,2,0,0
Myanmar,349,14,2002,2000.2,335,67,4,2,8,6,1,1,1,0,2,1
Ecuador,342,13,2002,2000.2,329,68,7,8,5,8,3,3,2,4,2,1
Guatemala,340,2,2002,2000.2,338,69,1,4,0,2,0,1,1,2,0,1
El Salvador,339,1,2002,2000.2,338,70,1,3,0,1,0,1,1,2,0,0
United Arab Emirates,335,3,2002,2000.2,332,71,3,1,2,1,1,0,2,1,0,0
Zimbabwe,320,10,2002,2000.2,310,72,4,5,3,7,2,2,1,2,1,1
Haiti,319,10,2002,2000.2,309,73,3,3,4,6,2,1,1,1,0,1
Congo,313,4,2002,2000.2,309,74,3,1,1,3,0,1,1,0,2,0
Qatar,313,11,2002,2000.2,302,75,6,2,9,2,4,1,2,1,0,0
Tanzania,299,12,2002,2000.2,287,76,10,3,12,0,3,0,4,3,3,0
Iceland,294,8,2002,2000.2,286,77,4,5,6,2,2,0,2,3,0,2
Martinique,290,22,2002,2000.2,268,78,7,4,15,7,3,3,3,0,1,1
Latvia,286,10,2002,2000.2,276,79,4,4,4,6,1,3,1,1,2,0
Estonia,275,12,2002,2000.2,263,80,7,4,10,2,5,1,1,1,1,2
Curaçao,273,3,2002,2000.2,270,81,1,3,1,2,1,0,0,2,0,1
Ethiopia,262,6,2002,2000.2,256,82,3,7,1,5,1,0,1,6,1,1
Syria,246,18,2002,2000.2,228,83,6,7,9,9,2,2,3,5,1,0
Togo,245,0,2002,2000.2,245,84,1,4,0,0,0,0,0,3,1,1
Suriname,233,8,2002,2000.2,225,85,1,1,6,2,1,1,0,0,0,0
Sudan,230,16,2002,2000.2,214,86,7,7,11,5,4,1,2,4,1,2
Burkina Faso,220,6,2002,2000.2,214,87,3,4,3,3,0,0,3,0,0,4
Canada,219,9,2002,2000.2,210,88,3,4,3,6,1,2,1,1,1,1
Oman,219,5,2002,2000.2,214,89,1,3,2,3,1,1,0,2,0,0
Lithuania,213,7,2002,2000.2,206,90,5,3,5,2,2,0,3,2,0,1
Gabon,201,0,2002,2000.2,201,91,1,3,0,0,0,0,1,2,0,1
Cuba,200,9,2002,2000.2,191,92,2,5,0,9,0,3,1,1,1,1
Libya,193,9,2002,2000.2,184,93,2,2,7,2,2,1,0,1,0,0
Bahrain,189,19,2002,2000.2,170,94,9,7,15,4,3,1,3,4,3,2
New Caledonia,175,26,2002,2000.2,149,95,3,4,10,16,1,2,2,2,0,0
Croatia,174,6,2002,2000.2,168,96,5,5,1,5,0,3,1,2,4,0
Angola,172,3,2002,2000.2,169,97,2,4,1,2,1,0,0,3,1,1
Cyprus,168,8,2002,2000.2,160,98,4,2,7,1,1,0,2,1,1,1
Mozambique,165,7,2002,2000.2,158,99,2,5,1,6,0,2,1,1,1,2
South Africa,163,26,2002,2000.2,137,100,12,11,16,10,7,2,1,3,4,6
Grenada,157,33,2002,2000.2,124,101,8,2,25,8,3,1,5,0,0,1
Serbia,157,10,2002,2000.2,147,102,2,8,6,4,2,1,0,5,0,2
Mauritius,154,5,2002,2000.2,149,103,4,2,4,1,1,1,2,0,1,1
Guadeloupe,153,15,2002,2000.2,138,104,1,5,4,11,1,4,0,1,0,0
Fiji,146,2,2002,2000.2,144,105,2,1,2,0,1,0,1,1,0,0
Jordan,144,27,2002,2000.2,117,106,9,9,14,13,5,5,2,2,2,2
Lebanon,137,6,2002,2000.2,131,107,3,4,4,2,1,0,1,3,1,1
Slovakia,135,11,2002,2000.2,124,108,3,6,6,5,1,1,1,4,1,1
Malta,133,9,2002,2000.2,124,109,7,3,8,1,3,0,2,3,2,0
Sierra Leone,133,7,2002,2000.2,126,110,2,2,4,3,2,1,0,1,0,0
Liberia,131,3,2002,2000.2,128,111,2,2,2,1,0,0,1,1,1,1
Barbados,129,6,2002,2000.2,123,112,4,2,4,2,1,1,1,1,2,0
St. Kitts and Nevis,120,12,2002,2000.2,108,113,5,2,11,1,4,0,0,2,1,0
Slovenia,117,10,2002,2000.2,107,114,5,6,8,2,3,1,2,3,0,2
Venezuela,110,5,2002,2000.2,105,115,4,1,5,0,3,0,0,1,1,0
Luxembourg,109,3,2002,2000.2,106,116,7,1,3,0,0,0,4,1,3,0
Vietnam,108,27,2002,2000.2,81,117,4,6,15,12,3,2,1,1,0,3
Albania,106,4,2002,2000.2,102,118,4,5,3,1,1,0,0,4,3,1
Antigua and Barbuda,101,6,2002,2000.2,95,119,2,2,5,1,1,0,0,2,1,0
Gambia,101,2,2002,2000.2,99,120,3,1,2,0,2,0,1,1,0,0
Georgia,100,6,2002,2000.2,94,121,1,3,4,2,1,0,0,3,0,0
Ukraine,100,10,2002,2000.2,90,122,4,6,6,4,3,0,1,3,0,3
Benin,99,5,2002,2000.2,94,123,1,2,4,1,1,0,0,1,0,1
Macedonia,96,13,2002,2000.2,83,124,4,5,9,4,2,0,2,1,0,4
Namibia,94,2,2002,2000.2,92,125,1,2,0,2,0,0,1,2,0,0
Niger,94,7,2002,2000.2,87,126,3,1,6,1,1,0,0,1,2,0
St. Lucia,94,18,2002,2000.2,76,127,4,5,11,7,2,2,2,3,0,0
Cambodia,90,5,2002,2000.2,85,128,1,4,1,4,1,0,0,4,0,0
Papua New Guinea,90,21,2002,2000.2,69,129,2,4,5,16,1,3,0,1,1,0
Swaziland,79,12,2002,2000.2,67,130,8,4,7,5,3,1,2,2,3,1
Guyana,77,3,2002,2000.2,74,131,1,2,2,1,1,0,0,2,0,0
Belarus,76,12,2002,2000.2,64,132,2,5,2,10,1,2,1,2,0,1
Lesotho,68,2,2002,2000.2,66,133,2,5,0,2,0,1,2,3,0,1
Kazakhstan,67,2,2002,2000.2,65,134,1,1,1,1,0,0,0,1,1,0
Faroe Islands,66,8,2002,2000.2,58,135,4,2,7,1,2,0,1,2,1,0
Yemen,66,6,2002,2000.2,60,136,3,2,3,3,0,0,1,2,2,0
Aruba,65,0,2002,2000.2,65,137,1,1,0,0,0,0,1,1,0,0
Moldova,57,3,2002,2000.2,54,138,3,5,2,1,1,0,2,4,0,1
Palestine,56,8,2002,2000.2,48,139,2,4,1,7,0,0,1,2,1,2
Mauritania,53,1,2002,2000.2,52,140,1,2,0,1,0,0,1,2,0,0
Burundi,49,3,2002,2000.2,46,141,1,3,1,2,0,0,0,2,1,1
Botswana,48,10,2002,2000.2,38,142,6,3,10,0,3,0,1,3,2,0
Armenia,46,4,2002,2000.2,42,143,1,2,2,2,0,1,0,1,1,0
Rwanda,42,7,2002,2000.2,35,144,3,4,3,4,2,1,0,3,1,0
Azerbaijan,38,2,2002,2000.2,36,145,3,5,2,0,1,0,2,3,0,2
British Virgin Islands,37,4,2002,2000.2,33,146,2,2,3,1,1,0,1,2,0,0
Dominican Republic,35,1,2002,2000.2,34,147,1,2,1,0,0,0,1,2,0,0
Chad,33,4,2002,2000.2,29,148,2,2,3,1,1,0,1,2,0,0
Philippines,29,3,2002,2000.2,26,149,1,4,1,2,0,0,1,4,0,0
Somalia,28,1,2002,2000.2,27,150,2,1,0,1,0,1,2,0,0,0
Puerto Rico,24,0,2002,2000.2,24,151,1,1,0,0,0,0,1,1,0,0
St. Martin,21,7,2002,2000.2,14,152,3,1,4,3,2,0,1,1,0,0
Liechtenstein,18,5,2002,2000.2,13,153,2,4,1,4,0,0,0,3,2,1
Andorra,16,4,2002,2000.2,12,154,3,3,2,2,1,0,2,2,0,1
Eritrea,13,5,2002,2000.2,8,155,2,4,2,3,1,0,1,2,0,2
Seychelles,12,1,2002,2000.2,11,156,1,2,1,0,1,0,0,2,0,0
Equatorial Guinea,10,1,2002,2000.2,9,157,1,1,1,0,0,0,1,1,0,0
San Marino,7,0,2002,2000.2,7,158,3,1,0,0,0,0,3,1,0,0
American Samoa,2,2,2002,2000.2,0,159,3,1,2,0,0,0,3,1,0,0
Germany,2023,15,2003,2000.3,2008,1,7,4,11,4,4,1,2,1,1,2
Sweden,1655,27,2003,2000.3,1628,2,5,7,10,17,2,5,3,2,0,0
Hungary,1582,17,2003,2000.3,1565,3,5,5,10,7,2,1,3,3,0,1
Brazil,1444,21,2003,2000.3,1423,4,7,10,10,11,4,4,1,3,2,3
England,1403,20,2003,2000.3,1383,5,7,4,14,6,5,3,2,0,0,1
Argentina,1335,27,2003,2000.3,1308,6,4,9,10,17,2,7,0,1,2,1
Netherlands,1143,23,2003,2000.3,1120,7,6,5,17,6,4,2,0,2,2,1
Austria,1120,14,2003,2000.3,1106,8,4,4,11,3,2,1,1,3,1,0
Denmark,1120,19,2003,2000.3,1101,9,4,4,5,14,2,4,0,0,2,0
South Korea,1075,35,2003,2000.3,1040,10,9,6,23,12,4,3,4,2,1,1
Scotland,1070,10,2003,2000.3,1060,11,8,4,9,1,4,0,2,3,2,1
France,1065,40,2003,2000.3,1025,12,10,4,31,9,9,4,1,0,0,0
Czech Republic,1030,30,2003,2000.3,1000,13,5,4,21,9,5,3,0,0,0,1
Belgium,993,16,2003,2000.3,977,14,5,3,11,5,4,1,0,1,1,1
Italy,975,21,2003,2000.3,954,15,6,5,14,7,6,3,0,1,0,1
Poland,960,32,2003,2000.3,928,16,6,9,15,17,4,6,1,2,1,1
Uruguay,954,32,2003,2000.3,922,17,4,9,9,23,3,4,0,2,1,3
Norway,946,10,2003,2000.3,936,18,6,7,4,6,2,2,2,4,2,1
Mexico,886,14,2003,2000.3,872,19,13,2,13,1,5,0,3,1,5,1
Russia,853,14,2003,2000.3,839,20,4,6,8,6,2,2,1,2,1,2
Spain,847,26,2003,2000.3,821,21,6,5,14,12,5,3,1,0,0,2
Switzerland,844,14,2003,2000.3,830,22,5,3,8,6,2,1,2,1,1,1
Romania,761,15,2003,2000.3,746,23,4,5,9,6,2,2,1,1,1,2
Zambia,729,15,2003,2000.3,714,24,3,7,4,11,1,4,0,1,2,2
Bulgaria,707,16,2003,2000.3,691,25,5,5,10,6,4,3,0,1,1,1
Paraguay,700,15,2003,2000.3,685,26,2,12,6,9,2,4,0,4,0,4
Chile,685,10,2003,2000.3,675,27,4,6,5,5,3,1,1,3,0,2
China,657,7,2003,2000.3,650,28,4,4,4,3,2,0,0,4,2,0
Finland,647,19,2003,2000.3,628,29,4,10,9,10,3,4,1,3,0,3
Ghana,643,18,2003,2000.3,625,30,6,4,15,3,3,0,1,3,2,1
Trinidad and Tobago,636,15,2003,2000.3,621,31,7,8,9,6,3,1,3,5,1,2
Wales,624,7,2003,2000.3,617,32,4,4,7,0,1,0,2,3,1,1
Thailand,601,17,2003,2000.3,584,33,8,2,16,1,5,0,2,2,1,0
Indonesia,592,10,2003,2000.3,582,34,2,5,4,6,1,2,0,2,1,1
Costa Rica,583,23,2003,2000.3,560,35,10,7,16,7,8,2,1,5,1,0
Portugal,579,24,2003,2000.3,555,36,8,4,21,3,5,2,1,1,2,1
Saudi Arabia,573,35,2003,2000.3,538,37,9,2,33,2,7,1,0,1,2,0
Egypt,566,29,2003,2000.3,537,38,8,4,26,3,7,3,1,1,0,0
Malaysia,562,10,2003,2000.3,552,39,4,3,7,3,1,0,0,3,3,0
Ireland,542,17,2003,2000.3,525,40,7,4,13,4,5,2,0,1,2,1
Ivory Coast,542,14,2003,2000.3,528,41,1,6,6,8,1,3,0,3,0,0
Iraq,530,24,2003,2000.3,506,42,5,8,17,7,4,2,1,3,0,3
Kenya,523,30,2003,2000.3,493,43,9,11,19,11,5,3,1,3,3,5
Nigeria,522,14,2003,2000.3,508,44,5,4,10,4,3,2,1,2,1,0
Northern Ireland,509,0,2003,2000.3,509,45,4,4,0,0,0,0,3,3,1,1
Japan,507,15,2003,2000.3,492,46,10,5,8,7,2,3,4,1,4,1
Peru,500,25,2003,2000.3,475,47,8,7,17,8,4,2,2,3,2,2
Uganda,492,18,2003,2000.3,474,48,10,6,14,4,6,0,2,1,2,5
Kuwait,488,21,2003,2000.3,467,49,8,4,14,7,5,2,1,1,2,1
USA,479,28,2003,2000.3,451,50,13,3,25,3,9,1,2,2,2,0
Malawi,465,11,2003,2000.3,454,51,7,7,5,6,0,1,4,3,3,3
Australia,460,6,2003,2000.3,454,52,1,2,2,4,1,1,0,1,0,0
Cameroon,455,5,2003,2000.3,450,53,4,5,4,1,3,1,1,2,0,2
Morocco,442,8,2003,2000.3,434,54,7,3,7,1,5,1,2,0,0,2
Algeria,438,17,2003,2000.3,421,55,8,4,14,3,4,2,2,0,2,2
Greece,434,16,2003,2000.3,418,56,3,8,3,13,3,5,0,0,0,3
Iran,428,15,2003,2000.3,413,57,4,4,8,7,3,1,1,2,0,1
Turkey,427,21,2003,2000.3,406,58,6,10,9,12,3,3,0,5,3,2
Honduras,424,19,2003,2000.3,405,59,8,10,7,12,1,3,4,5,3,2
Senegal,421,10,2003,2000.3,411,60,4,5,9,1,4,1,0,3,0,1
Democratic Republic of the Congo,405,19,2003,2000.3,386,61,3,7,7,12,3,3,0,0,0,4
Mali,402,13,2003,2000.3,389,62,3,6,3,10,2,6,0,0,1,0
Guinea,400,12,2003,2000.3,388,63,4,4,6,6,3,2,1,1,0,1
Colombia,396,9,2003,2000.3,387,64,9,8,7,2,1,2,4,3,4,3
Jamaica,396,25,2003,2000.3,371,65,10,9,22,3,6,1,3,6,1,2
Singapore,395,17,2003,2000.3,378,66,9,2,17,0,5,0,3,2,1,0
Israel,367,11,2003,2000.3,356,67,6,4,7,4,2,1,1,2,3,1
New Zealand,366,3,2003,2000.3,363,68,1,5,0,3,0,0,1,4,0,1
Myanmar,360,11,2003,2000.3,349,69,4,4,9,2,2,1,2,3,0,0
United Arab Emirates,358,23,2003,2000.3,335,70,9,4,18,5,3,2,1,2,5,0
Guatemala,355,15,2003,2000.3,340,71,5,9,9,6,2,2,3,2,0,5
Ecuador,352,10,2003,2000.3,342,72,6,4,9,1,4,0,0,3,2,1
El Salvador,352,13,2003,2000.3,339,73,8,7,7,6,3,2,3,4,2,1
Zimbabwe,349,29,2003,2000.3,320,74,7,9,13,16,6,4,0,3,1,2
Haiti,337,18,2003,2000.3,319,75,3,6,8,10,3,1,0,5,0,0
Qatar,327,14,2003,2000.3,313,76,6,8,9,5,2,1,1,4,3,3
Bolivia,326,9,2003,2000.3,317,77,3,5,8,1,3,0,0,5,0,0
Congo,322,9,2003,2000.3,313,78,6,4,8,1,4,0,0,2,2,2
Martinique,306,16,2003,2000.3,290,79,2,6,5,11,1,1,1,3,0,2
Iceland,302,8,2003,2000.3,294,80,2,6,2,6,1,2,0,3,1,1
Latvia,301,15,2003,2000.3,286,81,8,5,11,4,5,1,3,2,0,2
Tanzania,300,1,2003,2000.3,299,82,4,5,0,1,0,0,2,5,2,0
Estonia,286,11,2003,2000.3,275,83,7,9,6,5,2,2,3,7,2,0
Syria,271,25,2003,2000.3,246,84,5,4,23,2,3,0,1,2,1,2
Hong Kong,267,39,2003,2000.3,228,85,10,5,36,3,6,0,2,5,2,0
Ethiopia,266,4,2003,2000.3,262,86,3,3,4,0,2,0,1,2,0,1
India,265,16,2003,2000.3,249,87,4,4,9,7,2,2,1,2,1,0
Togo,258,13,2003,2000.3,245,88,4,3,12,1,4,0,0,2,0,1
Oman,256,37,2003,2000.3,219,89,8,6,20,17,7,3,1,1,0,2
Sudan,247,17,2003,2000.3,230,90,7,6,12,5,3,1,2,2,2,3
Burkina Faso,233,13,2003,2000.3,220,91,3,8,8,5,2,3,1,2,0,3
Canada,229,10,2003,2000.3,219,92,1,8,0,10,0,2,1,6,0,0
Lithuania,226,13,2003,2000.3,213,93,4,7,2,11,1,2,3,4,0,1
Gabon,224,23,2003,2000.3,201,94,5,10,11,12,3,2,0,5,2,3
Bahrain,216,27,2003,2000.3,189,95,9,4,21,6,6,1,1,2,2,1
Libya,215,22,2003,2000.3,193,96,5,4,17,5,2,2,2,2,1,0
Cuba,214,14,2003,2000.3,200,97,4,8,3,11,2,4,1,4,1,0
Croatia,193,19,2003,2000.3,174,98,6,6,10,9,3,4,0,2,3,0
Panama,192,8,2003,2000.3,184,99,8,1,8,0,3,0,4,1,1,0
Angola,189,17,2003,2000.3,172,100,5,5,10,7,3,1,1,2,1,2
New Caledonia,182,7,2003,2000.3,175,101,1,3,1,6,0,2,0,1,1,0
South Africa,178,15,2003,2000.3,163,102,7,4,9,6,4,2,2,2,1,0
Cyprus,176,8,2003,2000.3,168,103,5,4,5,3,0,1,3,3,2,0
Mozambique,172,7,2003,2000.3,165,104,5,3,7,0,3,0,1,2,1,1
Serbia,170,13,2003,2000.3,157,105,4,6,5,8,1,1,1,5,2,0
Uzbekistan,163,21,2003,2000.3,142,106,4,6,8,13,2,3,1,1,1,2
Mauritius,160,6,2003,2000.3,154,107,2,4,3,3,1,1,1,3,0,0
Guadeloupe,157,4,2003,2000.3,153,108,2,1,4,0,1,0,1,1,0,0
Jordan,154,10,2003,2000.3,144,109,4,3,6,4,3,1,0,2,1,0
Slovakia,151,16,2003,2000.3,135,110,4,6,7,9,1,3,1,2,2,1
Lebanon,141,4,2003,2000.3,137,111,3,5,1,3,1,0,2,4,0,1
Malta,140,7,2003,2000.3,133,112,4,3,4,3,0,0,3,1,1,2
Barbados,136,7,2003,2000.3,129,113,3,2,4,3,1,1,0,1,2,0
Liberia,136,5,2003,2000.3,131,114,3,3,5,0,2,0,1,3,0,0
Sierra Leone,136,3,2003,2000.3,133,115,3,3,3,0,1,0,0,3,2,0
Slovenia,133,16,2003,2000.3,117,116,6,4,10,6,3,1,3,0,0,3
Albania,126,20,2003,2000.3,106,117,5,6,13,7,4,0,0,6,1,0
Venezuela,125,15,2003,2000.3,110,118,6,6,12,3,5,1,1,4,0,1
Madagascar,121,9,2003,2000.3,112,119,4,7,3,6,1,0,2,6,1,1
Vietnam,116,8,2003,2000.3,108,120,3,4,6,2,2,1,1,3,0,0
Benin,115,16,2003,2000.3,99,121,8,5,13,3,5,1,2,3,1,1
Luxembourg,112,3,2003,2000.3,109,122,4,3,2,1,0,0,3,3,1,0
Georgia,109,9,2003,2000.3,100,123,5,3,7,2,2,0,1,3,2,0
Gambia,108,7,2003,2000.3,101,124,4,3,6,1,2,0,1,3,1,0
Macedonia,108,12,2003,2000.3,96,125,6,4,7,5,2,0,4,1,0,3
Ukraine,108,8,2003,2000.3,100,126,6,4,7,1,2,0,1,3,3,1
Solomon Islands,102,19,2003,2000.3,83,127,2,3,9,10,1,2,0,1,1,0
St. Lucia,100,6,2003,2000.3,94,128,2,1,6,0,1,0,1,1,0,0
Namibia,98,4,2003,2000.3,94,129,3,4,4,0,1,0,1,4,1,0
Niger,97,3,2003,2000.3,94,130,3,4,2,1,2,0,1,3,0,1
Swaziland,92,13,2003,2000.3,79,131,6,7,8,5,3,0,1,7,2,0
Yemen,89,23,2003,2000.3,66,132,5,6,9,14,2,1,2,4,1,1
Belarus,86,10,2003,2000.3,76,133,5,3,7,3,2,1,2,2,1,0
Bangladesh,83,11,2003,2000.3,72,134,6,3,8,3,4,0,1,2,1,1
Lesotho,81,13,2003,2000.3,68,135,8,5,11,2,3,1,2,3,3,1
Turkmenistan,81,20,2003,2000.3,61,136,4,3,16,4,4,1,0,0,0,2
Guinea-Bissau,79,1,2003,2000.3,78,137,1,1,1,0,0,0,1,1,0,0
Faroe Islands,75,9,2003,2000.3,66,138,5,2,7,2,2,0,3,2,0,0
Sri Lanka,72,9,2003,2000.3,63,139,3,9,6,3,3,0,0,7,0,2
Moldova,66,9,2003,2000.3,57,140,3,7,4,5,2,1,1,4,0,2
Botswana,60,12,2003,2000.3,48,141,7,5,5,7,1,2,3,1,3,2
Pakistan,60,8,2003,2000.3,52,142,4,5,3,5,1,3,3,2,0,0
Maldives,57,26,2003,2000.3,31,143,4,6,19,7,2,3,1,2,1,1
Rwanda,57,15,2003,2000.3,42,144,8,6,11,4,3,1,2,3,3,2
Mauritania,56,3,2003,2000.3,53,145,3,4,2,1,1,0,0,4,2,0
Nepal,55,8,2003,2000.3,47,146,7,4,8,0,2,0,5,4,0,0
Burundi,53,4,2003,2000.3,49,147,4,3,0,4,0,0,2,3,2,0
Armenia,51,5,2003,2000.3,46,148,3,4,1,4,1,1,2,3,0,0
Cape Verde,50,12,2003,2000.3,38,149,3,4,8,4,3,0,0,3,0,1
Tajikistan,50,7,2003,2000.3,43,150,3,5,4,3,2,2,1,1,0,2
Jersey,48,5,2003,2000.3,43,151,1,2,1,4,1,0,0,1,0,1
Azerbaijan,46,8,2003,2000.3,38,152,2,5,3,5,1,0,1,3,0,2
Chad,39,6,2003,2000.3,33,153,3,2,5,1,2,0,0,2,1,0
Central African Republic,37,3,2003,2000.3,34,154,3,2,2,1,1,0,1,2,1,0
Kyrgyzstan,35,9,2003,2000.3,26,155,2,2,5,4,1,2,1,0,0,0
Laos,33,3,2003,2000.3,30,156,2,2,2,1,1,0,0,2,1,0
Macau,25,6,2003,2000.3,19,157,4,3,4,2,1,1,3,2,0,0
Tonga,25,2,2003,2000.3,23,158,1,1,0,2,0,0,1,0,0,1
Liechtenstein,22,4,2003,2000.3,18,159,5,3,3,1,1,0,3,3,1,0
Guam,18,0,2003,2000.3,18,160,3,3,0,0,0,0,3,3,0,0
Equatorial Guinea,17,7,2003,2000.3,10,161,4,4,6,1,3,0,1,4,0,0
Eritrea,17,4,2003,2000.3,13,162,3,5,1,3,1,0,1,5,1,0
Andorra,16,0,2003,2000.3,16,163,4,3,0,0,0,0,4,3,0,0
Seychelles,16,4,2003,2000.3,12,164,3,3,2,2,1,0,2,2,0,1
Mongolia,9,7,2003,2000.3,2,165,2,5,2,5,1,1,1,3,0,1
São Tomé and Príncipe,9,1,2003,2000.3,8,166,1,2,0,1,0,0,1,2,0,0
San Marino,9,2,2003,2000.3,7,167,2,4,0,2,0,0,2,3,0,1
Bhutan,8,6,2003,2000.3,2,168,4,7,6,0,1,0,2,7,1,0
Kiribati,5,2,2003,2000.3,3,169,1,3,0,2,0,0,1,3,0,0
Afghanistan,4,2,2003,2000.3,2,170,3,4,0,2,0,1,3,3,0,0
Guernsey,3,3,2003,2000.3,0,171,1,1,3,0,0,0,0,1,1,0
Tuvalu,3,3,2003,2000.3,0,172,3,2,3,0,1,0,2,2,0,0
Germany,2058,35,2004,2000.4,2023,1,7,9,16,19,3,6,2,2,2,1
Sweden,1693,38,2004,2000.4,1655,2,8,8,14,24,4,4,2,1,2,3
Hungary,1606,24,2004,2000.4,1582,3,6,7,14,10,4,4,2,3,0,0
Brazil,1480,36,2004,2000.4,1444,4,6,12,12,24,4,4,1,1,1,7
England,1431,28,2004,2000.4,1403,5,5,9,15,13,4,3,0,3,1,3
Argentina,1368,33,2004,2000.4,1335,6,11,6,25,8,7,4,2,1,2,1
Netherlands,1173,30,2004,2000.4,1143,7,11,6,21,9,7,1,3,1,1,4
Denmark,1139,19,2004,2000.4,1120,8,6,7,6,13,1,3,1,2,4,2
Austria,1134,14,2004,2000.4,1120,9,6,2,10,4,2,0,2,0,2,2
South Korea,1106,31,2004,2000.4,1075,10,13,4,26,5,8,2,2,0,3,2
France,1083,18,2004,2000.4,1065,11,8,6,7,11,3,4,1,0,4,2
Scotland,1079,9,2004,2000.4,1070,12,6,5,6,3,1,1,4,2,1,2
Czech Republic,1054,24,2004,2000.4,1030,13,7,8,11,13,5,4,1,3,1,1
Belgium,999,6,2004,2000.4,993,14,4,4,3,3,0,1,3,2,1,1
Italy,995,20,2004,2000.4,975,15,7,6,13,7,4,3,0,2,3,1
Poland,982,22,2004,2000.4,960,16,7,6,11,11,3,3,3,1,1,2
Norway,975,29,2004,2000.4,946,17,6,7,12,17,3,5,0,1,3,1
Uruguay,971,17,2004,2000.4,954,18,6,8,6,11,3,2,2,4,1,2
Mexico,937,51,2004,2000.4,886,19,11,5,32,19,8,4,1,1,2,0
Russia,873,20,2004,2000.4,853,20,4,7,11,9,3,1,0,4,1,2
Spain,865,18,2004,2000.4,847,21,8,4,16,2,7,0,0,1,1,3
Switzerland,858,14,2004,2000.4,844,22,8,4,11,3,3,0,2,3,3,1
Romania,781,20,2004,2000.4,761,23,4,5,12,8,4,2,0,2,0,1
Zambia,745,16,2004,2000.4,729,24,7,8,8,8,4,2,1,2,2,4
Bulgaria,725,18,2004,2000.4,707,25,4,9,9,9,2,1,1,4,1,4
Paraguay,709,9,2004,2000.4,700,26,5,7,4,5,1,2,1,2,3,3
China,702,45,2004,2000.4,657,27,17,5,42,3,12,3,1,1,4,1
Chile,694,9,2004,2000.4,685,28,4,8,2,7,0,2,0,4,4,2
Trinidad and Tobago,676,40,2004,2000.4,636,29,10,11,23,17,8,4,2,5,0,2
Finland,664,17,2004,2000.4,647,30,4,8,7,10,2,3,1,5,1,0
Ghana,650,7,2004,2000.4,643,31,5,2,6,1,2,0,0,1,3,1
Wales,636,12,2004,2000.4,624,32,4,4,9,3,2,1,1,1,1,2
Indonesia,623,31,2004,2000.4,592,33,7,11,15,16,3,3,2,6,2,2
Thailand,622,21,2004,2000.4,601,34,13,5,17,4,3,1,5,4,5,0
Portugal,618,39,2004,2000.4,579,35,13,3,30,9,7,2,3,0,3,1
Costa Rica,606,23,2004,2000.4,583,36,7,7,16,7,4,1,2,4,1,2
Saudi Arabia,602,29,2004,2000.4,573,37,9,9,18,11,4,6,2,2,3,1
Egypt,595,29,2004,2000.4,566,38,9,6,19,10,5,2,1,2,3,2
Malaysia,576,14,2004,2000.4,562,39,8,6,9,5,3,2,4,4,1,0
Iraq,560,30,2004,2000.4,530,40,9,11,19,11,4,2,4,6,1,3
Ivory Coast,560,18,2004,2000.4,542,41,3,5,11,7,3,4,0,1,0,0
Ireland,555,13,2004,2000.4,542,42,9,4,11,2,6,1,1,0,2,3
Japan,554,47,2004,2000.4,507,43,12,10,22,25,8,8,2,1,2,1
Nigeria,548,26,2004,2000.4,522,44,8,7,15,11,6,3,1,2,1,2
Kenya,545,22,2004,2000.4,523,45,7,8,14,8,3,2,2,4,2,2
Kuwait,536,48,2004,2000.4,488,46,16,14,34,14,8,5,5,5,3,4
Northern Ireland,522,13,2004,2000.4,509,47,4,6,5,8,0,2,2,0,2,4
Peru,517,17,2004,2000.4,500,48,8,6,10,7,2,1,3,3,3,2
Tunisia,507,23,2004,2000.4,484,49,13,3,19,4,8,0,3,1,2,2
USA,506,27,2004,2000.4,479,50,8,6,19,8,5,3,0,1,3,2
Uganda,503,11,2004,2000.4,492,51,6,8,6,5,2,0,2,6,2,2
Australia,488,28,2004,2000.4,460,52,9,2,22,6,5,1,2,0,2,1
Iran,482,54,2004,2000.4,428,53,11,7,35,19,9,4,2,0,0,3
Malawi,475,10,2004,2000.4,465,54,5,4,6,4,0,1,1,3,4,0
Cameroon,469,14,2004,2000.4,455,55,6,5,11,3,3,0,1,3,2,2
Morocco,469,27,2004,2000.4,442,56,9,6,22,5,6,2,1,1,2,3
Greece,451,17,2004,2000.4,434,57,6,10,8,9,4,4,0,4,2,2
Algeria,449,11,2004,2000.4,438,58,9,5,7,4,1,0,5,2,3,3
Honduras,449,25,2004,2000.4,424,59,8,9,9,16,1,3,0,4,7,2
Turkey,445,18,2004,2000.4,427,60,4,8,6,12,1,4,2,1,1,3
Senegal,443,22,2004,2000.4,421,61,8,6,11,11,4,3,1,2,3,1
Jamaica,433,37,2004,2000.4,396,62,11,7,30,7,6,1,1,2,4,4
Mali,420,18,2004,2000.4,402,63,4,10,5,13,1,4,0,5,3,1
Colombia,418,22,2004,2000.4,396,64,6,10,11,11,4,4,1,2,1,4
Guinea,418,18,2004,2000.4,400,65,4,8,8,10,3,1,0,3,1,4
Singapore,418,23,2004,2000.4,395,66,9,8,15,8,4,2,4,4,1,2
Democratic Republic of the Congo,414,9,2004,2000.4,405,67,5,6,6,3,2,0,3,3,0,3
United Arab Emirates,385,27,2004,2000.4,358,68,10,10,14,13,3,2,5,4,2,4
Guatemala,383,28,2004,2000.4,355,69,8,11,13,15,6,5,2,2,0,4
Israel,377,10,2004,2000.4,367,70,4,4,7,3,2,2,0,1,2,1
Qatar,375,48,2004,2000.4,327,71,16,9,38,10,9,2,3,5,4,2
New Zealand,373,7,2004,2000.4,366,72,2,2,5,2,1,1,1,1,0,0
Ecuador,369,17,2004,2000.4,352,73,5,10,8,9,4,0,1,8,0,2
Myanmar,369,9,2004,2000.4,360,74,1,8,3,6,0,2,1,4,0,2
Zimbabwe,369,20,2004,2000.4,349,75,7,8,6,14,2,3,2,3,3,2
El Salvador,362,10,2004,2000.4,352,76,11,4,8,2,2,0,7,2,2,2
Haiti,357,20,2004,2000.4,337,77,5,9,8,12,2,3,1,3,2,3
Bolivia,335,9,2004,2000.4,326,78,4,7,3,6,2,0,1,5,1,2
Congo,327,5,2004,2000.4,322,79,2,2,5,0,1,0,1,2,0,0
Latvia,324,23,2004,2000.4,301,80,9,8,10,13,1,3,4,4,4,1
Iceland,312,10,2004,2000.4,302,81,4,5,6,4,1,0,3,3,0,2
Martinique,311,5,2004,2000.4,306,82,3,2,5,0,1,0,1,1,1,1
Estonia,302,16,2004,2000.4,286,83,6,8,10,6,2,1,2,5,2,2
Oman,301,45,2004,2000.4,256,84,13,12,27,18,8,6,3,4,2,2
Tanzania,301,1,2004,2000.4,300,85,2,1,1,0,0,0,2,1,0,0
Syria,299,28,2004,2000.4,271,86,5,16,8,20,2,7,1,4,2,5
Curaçao,289,16,2004,2000.4,273,87,5,3,15,1,4,0,1,2,0,1
Bahrain,274,58,2004,2000.4,216,88,16,17,29,29,7,6,4,5,5,6
Hong Kong,274,7,2004,2000.4,267,89,4,4,4,3,1,1,2,2,1,1
India,274,9,2004,2000.4,265,90,4,6,4,5,2,1,2,3,0,2
Togo,266,8,2004,2000.4,258,91,4,4,7,1,3,1,0,1,1,2
Sudan,263,16,2004,2000.4,247,92,10,4,11,5,3,1,5,1,2,2
Burkina Faso,249,16,2004,2000.4,233,93,6,9,11,5,4,0,2,6,0,3
Suriname,249,16,2004,2000.4,233,94,3,6,10,6,1,1,0,3,2,2
Canada,242,13,2004,2000.4,229,95,5,5,10,3,2,2,2,2,1,1
Lithuania,237,11,2004,2000.4,226,96,2,6,4,7,1,1,0,4,1,1
Gabon,234,10,2004,2000.4,224,97,4,3,6,4,1,1,0,2,3,0
Cuba,232,18,2004,2000.4,214,98,7,3,13,5,3,2,0,0,4,1
Libya,232,17,2004,2000.4,215,99,9,3,14,3,7,1,0,2,2,0
Panama,216,24,2004,2000.4,192,100,6,11,14,10,3,3,0,4,3,4
Croatia,211,18,2004,2000.4,193,101,8,5,14,4,3,3,2,1,3,1
Angola,203,14,2004,2000.4,189,102,5,7,6,8,4,2,0,1,1,4
New Caledonia,198,16,2004,2000.4,182,103,2,1,16,0,2,0,0,1,0,0
South Africa,191,13,2004,2000.4,178,104,4,9,8,5,4,2,0,6,0,1
Jordan,188,34,2004,2000.4,154,105,10,17,16,18,5,6,1,4,4,7
Cyprus,187,11,2004,2000.4,176,106,8,2,10,1,3,0,3,2,2,0
Serbia,184,14,2004,2000.4,170,107,3,5,7,7,2,2,1,1,0,2
Uzbekistan,184,21,2004,2000.4,163,108,5,5,13,8,3,4,0,1,2,0
Grenada,179,22,2004,2000.4,157,109,6,6,16,6,3,1,2,4,1,1
Slovakia,171,20,2004,2000.4,151,110,5,7,15,5,3,1,0,3,2,3
Fiji,168,22,2004,2000.4,146,111,6,2,17,5,3,1,3,1,0,0
Guadeloupe,166,9,2004,2000.4,157,112,2,1,9,0,2,0,0,0,0,1
Mauritius,163,3,2004,2000.4,160,113,1,1,2,1,1,0,0,1,0,0
Lebanon,162,21,2004,2000.4,141,114,8,8,10,11,2,2,2,5,4,1
Malta,149,9,2004,2000.4,140,115,6,3,6,3,1,0,3,3,2,0
Barbados,148,12,2004,2000.4,136,116,6,3,5,7,2,2,3,1,1,0
Venezuela,143,18,2004,2000.4,125,117,8,7,9,9,2,1,4,5,2,1
St. Kitts and Nevis,142,22,2004,2000.4,120,118,10,4,19,3,4,1,5,3,1,0
Vietnam,141,25,2004,2000.4,116,119,9,3,25,0,5,0,3,2,1,1
Slovenia,139,6,2004,2000.4,133,120,4,5,5,1,2,0,1,3,1,2
Liberia,137,1,2004,2000.4,136,121,3,2,1,0,1,0,1,2,1,0
Albania,135,9,2004,2000.4,126,122,4,4,6,3,3,1,1,2,0,1
Benin,127,12,2004,2000.4,115,123,5,10,5,7,1,0,2,9,2,1
Solomon Islands,125,23,2004,2000.4,102,124,4,7,14,9,3,4,1,2,0,1
Luxembourg,119,7,2004,2000.4,112,125,4,5,3,4,0,0,4,5,0,0
Ukraine,119,11,2004,2000.4,108,126,3,7,4,7,1,2,0,3,2,2
St. Lucia,118,18,2004,2000.4,100,127,4,7,13,5,2,2,1,4,1,1
Macedonia,116,8,2004,2000.4,108,128,4,5,3,5,1,1,2,3,1,1
Georgia,115,6,2004,2000.4,109,129,4,5,4,2,1,0,2,4,1,1
Antigua and Barbuda,112,11,2004,2000.4,101,130,2,4,3,8,1,2,1,2,0,0
Papua New Guinea,107,17,2004,2000.4,90,131,1,3,1,16,0,2,0,1,1,0
Belarus,106,20,2004,2000.4,86,132,3,5,9,11,3,3,0,1,0,1
Yemen,101,12,2004,2000.4,89,133,8,9,9,3,2,0,5,7,1,2
Dominica,100,9,2004,2000.4,91,134,1,8,0,9,0,3,1,4,0,1
Namibia,99,1,2004,2000.4,98,135,1,1,0,1,0,0,0,1,1,0
Bermuda,98,33,2004,2000.4,65,136,8,6,22,11,3,2,3,4,2,0
Swaziland,96,4,2004,2000.4,92,137,1,4,0,4,0,1,1,1,0,2
Turkmenistan,95,14,2004,2000.4,81,138,5,7,7,7,2,1,3,4,0,2
Cambodia,92,2,2004,2000.4,90,139,1,3,0,2,0,0,1,3,0,0
Vanuatu,86,22,2004,2000.4,64,140,3,7,2,20,0,4,3,2,0,1
Faroe Islands,84,9,2004,2000.4,75,141,3,5,7,2,2,0,1,4,0,1
Guyana,80,3,2004,2000.4,77,142,1,3,1,2,0,1,1,2,0,0
Kazakhstan,76,9,2004,2000.4,67,143,4,4,6,3,0,0,3,4,1,0
Sri Lanka,76,4,2004,2000.4,72,144,3,4,4,0,0,0,1,3,2,1
Rwanda,75,18,2004,2000.4,57,145,6,9,7,11,2,2,1,6,3,1
Moldova,71,5,2004,2000.4,66,146,4,5,4,1,2,0,1,3,1,2
Palestine,69,13,2004,2000.4,56,147,4,5,10,3,1,0,1,4,2,1
Aruba,68,3,2004,2000.4,65,148,1,2,1,2,0,0,1,2,0,0
Botswana,68,8,2004,2000.4,60,149,4,8,5,3,3,0,1,3,0,5
Maldives,64,7,2004,2000.4,57,150,6,5,6,1,1,0,3,5,2,0
Burundi,61,8,2004,2000.4,53,151,1,4,3,5,1,2,0,2,0,0
Armenia,59,8,2004,2000.4,51,152,4,4,2,6,1,1,2,2,1,1
Azerbaijan,57,11,2004,2000.4,46,153,5,5,4,7,1,1,1,2,3,2
Cape Verde,55,5,2004,2000.4,50,154,4,2,4,1,2,0,1,2,1,0
Tajikistan,55,5,2004,2000.4,50,155,3,4,2,3,1,1,1,3,1,0
Cayman Islands,48,3,2004,2000.4,45,156,2,2,2,1,0,1,2,1,0,0
Dominican Republic,42,7,2004,2000.4,35,157,3,2,6,1,1,0,1,2,1,0
British Virgin Islands,40,3,2004,2000.4,37,158,5,4,1,2,0,1,5,3,0,0
Kyrgyzstan,40,5,2004,2000.4,35,159,3,5,3,2,0,1,2,3,1,1
Laos,40,7,2004,2000.4,33,160,5,5,5,2,1,0,4,5,0,0
Nicaragua,33,8,2004,2000.4,25,161,3,4,5,3,2,0,0,3,1,1
Philippines,31,2,2004,2000.4,29,162,1,2,0,2,0,0,1,2,0,0
Liechtenstein,30,8,2004,2000.4,22,163,4,5,4,4,0,1,3,4,1,0
Somalia,28,0,2004,2000.4,28,164,1,2,0,0,0,0,1,2,0,0
Puerto Rico,27,3,2004,2000.4,24,165,1,2,1,2,0,0,0,2,1,0
Tonga,27,2,2004,2000.4,25,166,1,2,2,0,1,0,0,2,0,0
Samoa,23,5,2004,2000.4,18,167,4,1,5,0,1,0,3,0,0,1
St. Martin,21,0,2004,2000.4,21,168,1,1,0,0,0,0,1,1,0,0
Andorra,18,2,2004,2000.4,16,169,4,3,2,0,1,0,2,3,1,0
Cook Islands,11,1,2004,2000.4,10,170,1,3,0,1,0,0,0,3,1,0
Montserrat,10,5,2004,2000.4,5,171,2,2,4,1,0,0,2,2,0,0
San Marino,10,1,2004,2000.4,9,172,3,2,1,0,1,0,2,2,0,0
American Samoa,3,1,2004,2000.4,2,173,2,2,1,0,0,0,2,2,0,0
Turks and Caicos Islands,0,0,2004,2000.4,0,174,1,1,0,0,0,0,1,1,0,0
Germany,2090,32,2005,2000.5,2058,1,9,6,24,8,5,2,1,2,3,2
Sweden,1717,24,2005,2000.5,1693,2,6,6,17,7,4,2,1,1,1,3
Hungary,1620,14,2005,2000.5,1606,3,6,7,6,8,1,2,2,5,3,0
Brazil,1527,47,2005,2000.5,1480,4,7,9,23,24,7,3,0,2,0,4
England,1450,19,2005,2000.5,1431,5,6,5,12,7,5,3,0,2,1,0
Argentina,1396,28,2005,2000.5,1368,6,4,13,8,20,4,4,0,5,0,4
Netherlands,1193,20,2005,2000.5,1173,7,6,5,11,9,3,4,1,0,2,1
Denmark,1162,23,2005,2000.5,1139,8,5,5,17,6,5,2,0,2,0,1
Austria,1145,11,2005,2000.5,1134,9,4,5,6,5,2,1,0,2,2,2
South Korea,1126,20,2005,2000.5,1106,10,10,6,12,8,5,1,3,2,2,3
France,1102,19,2005,2000.5,1083,11,8,3,16,3,5,1,0,0,3,2
Scotland,1090,11,2005,2000.5,1079,12,4,5,4,7,1,2,1,1,2,2
Czech Republic,1089,35,2005,2000.5,1054,13,6,6,23,12,5,4,1,2,0,0
Poland,1017,35,2005,2000.5,982,14,10,4,27,8,9,2,1,1,0,1
Italy,1015,20,2005,2000.5,995,15,6,7,8,12,4,3,0,0,2,4
Belgium,1012,13,2005,2000.5,999,16,3,4,10,3,2,1,1,1,0,2
Norway,992,17,2005,2000.5,975,17,6,10,3,14,2,6,3,1,1,3
Mexico,981,44,2005,2000.5,937,18,17,9,32,12,10,3,2,4,5,2
Uruguay,980,9,2005,2000.5,971,19,4,7,6,3,3,0,0,3,1,4
Spain,893,28,2005,2000.5,865,20,7,4,19,9,6,2,0,0,1,2
Russia,888,15,2005,2000.5,873,21,4,6,9,6,3,1,0,1,1,4
Switzerland,875,17,2005,2000.5,858,22,4,7,5,12,2,4,0,1,2,2
Romania,797,16,2005,2000.5,781,23,7,3,13,3,4,2,2,1,1,0
Zambia,770,25,2005,2000.5,745,24,8,7,15,10,5,2,2,1,1,4
Bulgaria,745,20,2005,2000.5,725,25,7,4,15,5,4,1,2,1,1,2
Paraguay,730,21,2005,2000.5,709,26,7,5,15,6,5,2,1,3,1,0
China,709,7,2005,2000.5,702,27,3,5,4,3,1,0,1,3,1,2
Trinidad and Tobago,708,32,2005,2000.5,676,28,15,11,22,10,9,3,3,7,3,1
Chile,706,12,2005,2000.5,694,29,5,4,9,3,3,0,0,3,2,1
Finland,686,22,2005,2000.5,664,30,6,7,7,15,1,5,4,1,1,1
Ghana,666,16,2005,2000.5,650,31,2,6,4,12,2,3,0,0,0,3
Costa Rica,643,37,2005,2000.5,606,32,10,14,21,16,6,4,2,7,2,3
Wales,643,7,2005,2000.5,636,33,5,4,4,3,2,1,2,3,1,0
Portugal,642,24,2005,2000.5,618,34,7,5,21,3,7,1,0,1,0,3
Indonesia,629,6,2005,2000.5,623,35,1,3,1,5,0,1,1,2,0,0
Egypt,627,32,2005,2000.5,595,36,9,6,28,4,7,3,1,2,1,1
Saudi Arabia,622,20,2005,2000.5,602,37,10,6,17,3,6,1,3,2,1,3
Japan,581,27,2005,2000.5,554,38,11,6,21,6,6,3,3,2,2,1
Malaysia,580,4,2005,2000.5,576,39,3,1,4,0,1,0,2,1,0,0
Iraq,578,18,2005,2000.5,560,40,3,7,11,7,3,1,0,2,0,4
Ivory Coast,575,15,2005,2000.5,560,41,5,4,10,5,2,2,1,1,2,1
Ireland,564,9,2005,2000.5,555,42,6,3,5,4,2,2,2,0,2,1
Nigeria,563,15,2005,2000.5,548,43,3,4,8,7,2,2,0,1,1,1
Kenya,550,5,2005,2000.5,545,44,5,4,4,1,1,0,1,4,3,0
Kuwait,548,12,2005,2000.5,536,45,10,3,10,2,3,0,3,3,4,0
USA,539,33,2005,2000.5,506,46,14,6,26,7,11,2,1,2,2,2
Tunisia,535,28,2005,2000.5,507,47,5,7,16,12,4,4,0,2,1,1
Northern Ireland,530,8,2005,2000.5,522,48,6,4,7,1,2,0,3,3,1,1
Peru,528,11,2005,2000.5,517,49,5,5,9,2,2,1,0,4,3,0
Uganda,525,22,2005,2000.5,503,50,2,11,3,19,1,4,0,6,1,1
Australia,515,27,2005,2000.5,488,51,8,4,21,6,6,1,2,2,0,1
Iran,494,12,2005,2000.5,482,52,5,3,11,1,5,0,0,2,0,1
Malawi,489,14,2005,2000.5,475,53,4,6,8,6,3,1,1,4,0,1
Morocco,482,13,2005,2000.5,469,54,6,2,11,2,4,0,1,0,1,2
Cameroon,481,12,2005,2000.5,469,55,4,3,5,7,3,2,0,0,1,1
Honduras,475,26,2005,2000.5,449,56,5,9,12,14,5,2,0,3,0,4
Turkey,469,24,2005,2000.5,445,57,5,6,10,14,3,4,0,2,2,0
Greece,463,12,2005,2000.5,451,58,7,6,7,5,4,2,2,3,1,1
Senegal,462,19,2005,2000.5,443,59,4,6,11,8,2,3,0,2,2,1
Algeria,458,9,2005,2000.5,449,60,5,2,8,1,2,0,2,1,1,1
Jamaica,448,15,2005,2000.5,433,61,3,8,5,10,1,5,0,3,2,0
Colombia,443,25,2005,2000.5,418,62,8,9,17,8,4,2,3,4,1,3
Democratic Republic of the Congo,435,21,2005,2000.5,414,63,7,7,13,8,3,0,0,3,4,4
Guinea,433,15,2005,2000.5,418,64,5,6,9,6,3,2,0,4,2,0
Mali,433,13,2005,2000.5,420,65,3,5,7,6,2,1,1,3,0,1
Singapore,433,15,2005,2000.5,418,66,3,3,8,7,3,3,0,0,0,0
Guatemala,418,35,2005,2000.5,383,67,17,7,29,6,7,0,6,6,4,1
United Arab Emirates,394,9,2005,2000.5,385,68,5,5,4,5,0,2,2,0,3,3
Ecuador,393,24,2005,2000.5,369,69,11,6,18,6,6,2,3,2,2,2
Israel,391,14,2005,2000.5,377,70,4,5,7,7,1,1,0,1,3,3
Zimbabwe,390,21,2005,2000.5,369,71,5,9,7,14,3,4,0,4,2,1
Haiti,364,7,2005,2000.5,357,72,1,6,0,7,0,1,1,3,0,2
El Salvador,363,1,2005,2000.5,362,73,1,2,0,1,0,0,1,2,0,0
Bolivia,344,9,2005,2000.5,335,74,4,3,6,3,1,0,2,3,1,0
Latvia,338,14,2005,2000.5,324,75,6,7,10,4,2,0,1,5,3,2
Congo,334,7,2005,2000.5,327,76,4,7,3,4,1,2,2,4,1,1
Iceland,328,16,2005,2000.5,312,77,4,5,11,5,2,0,2,4,0,1
Estonia,314,12,2005,2000.5,302,78,6,5,7,5,2,1,3,3,1,1
Syria,308,9,2005,2000.5,299,79,2,5,2,7,0,1,1,2,1,2
Oman,306,5,2005,2000.5,301,80,2,2,1,4,0,0,1,0,1,2
Hong Kong,304,30,2005,2000.5,274,81,3,1,15,15,2,1,1,0,0,0
Bahrain,295,21,2005,2000.5,274,82,11,5,18,3,3,0,3,2,5,3
India,286,12,2005,2000.5,274,83,2,8,5,7,2,3,0,3,0,2
Ethiopia,285,19,2005,2000.5,266,84,3,4,6,13,2,3,0,1,1,0
Sudan,285,22,2005,2000.5,263,85,7,6,11,11,3,2,3,3,1,1
Togo,284,18,2005,2000.5,266,86,3,6,8,10,3,3,0,2,0,1
Burkina Faso,258,9,2005,2000.5,249,87,3,5,6,3,2,0,1,4,0,1
Canada,249,7,2005,2000.5,242,88,3,5,3,4,1,2,2,3,0,0
Gabon,246,12,2005,2000.5,234,89,8,3,12,0,4,0,2,3,2,0
Cuba,242,10,2005,2000.5,232,90,2,6,1,9,0,3,1,3,1,0
Lithuania,241,4,2005,2000.5,237,91,4,3,4,0,2,0,1,3,1,0
Libya,237,5,2005,2000.5,232,92,5,5,3,2,1,0,1,4,3,1
Croatia,230,19,2005,2000.5,211,93,4,6,9,10,3,2,0,1,1,3
Panama,229,13,2005,2000.5,216,94,7,17,4,9,0,3,4,11,3,3
South Africa,217,26,2005,2000.5,191,95,8,8,12,14,2,3,2,3,4,2
Angola,216,13,2005,2000.5,203,96,5,7,8,5,3,2,1,3,1,2
Cyprus,198,11,2005,2000.5,187,97,7,3,8,3,3,1,3,2,1,0
Serbia,195,11,2005,2000.5,184,98,3,8,2,9,1,2,0,3,2,3
Uzbekistan,192,8,2005,2000.5,184,99,4,4,6,2,1,0,0,3,3,1
Jordan,191,3,2005,2000.5,188,100,3,2,0,3,0,0,1,2,2,0
Slovakia,186,15,2005,2000.5,171,101,5,7,5,10,2,2,0,2,3,3
Mozambique,176,4,2005,2000.5,172,102,3,1,4,0,2,0,1,0,0,1
Mauritius,168,5,2005,2000.5,163,103,3,2,3,2,1,1,1,1,1,0
Venezuela,155,12,2005,2000.5,143,104,6,4,9,3,2,0,1,4,3,0
Malta,153,4,2005,2000.5,149,105,4,4,3,1,0,0,1,4,3,0
Albania,145,10,2005,2000.5,135,106,5,5,7,3,3,0,2,4,0,1
Slovenia,145,6,2005,2000.5,139,107,5,4,3,3,0,1,4,1,1,2
Sierra Leone,142,6,2005,2000.5,136,108,3,2,5,1,3,0,0,1,0,1
Liberia,139,2,2005,2000.5,137,109,2,4,0,2,0,0,2,4,0,0
Ukraine,131,12,2005,2000.5,119,110,7,3,8,4,4,2,1,0,2,1
Benin,130,3,2005,2000.5,127,111,2,4,2,1,1,0,1,3,0,1
Georgia,130,15,2005,2000.5,115,112,6,5,8,7,2,1,2,4,2,0
Solomon Islands,126,1,2005,2000.5,125,113,1,1,1,0,0,0,1,1,0,0
Macedonia,123,7,2005,2000.5,116,114,3,5,1,6,0,2,2,2,1,1
Madagascar,123,2,2005,2000.5,121,115,1,1,2,0,1,0,0,1,0,0
Luxembourg,120,1,2005,2000.5,119,116,3,4,0,1,0,0,3,4,0,0
Antigua and Barbuda,116,4,2005,2000.5,112,117,2,1,2,2,1,0,1,1,0,0
Belarus,116,10,2005,2000.5,106,118,5,5,5,5,1,2,2,2,2,1
Gambia,110,2,2005,2000.5,108,119,1,1,2,0,0,0,1,1,0,0
Namibia,102,3,2005,2000.5,99,120,1,1,1,2,0,1,0,0,1,0
Bangladesh,91,8,2005,2000.5,83,121,5,2,6,2,2,2,1,0,2,0
Guyana,89,9,2005,2000.5,80,122,2,1,6,3,2,0,0,0,0,1
Rwanda,87,12,2005,2000.5,75,123,7,4,10,2,4,0,2,3,1,1
Faroe Islands,86,2,2005,2000.5,84,124,4,2,1,1,0,0,4,2,0,0
Lesotho,86,5,2005,2000.5,81,125,3,1,5,0,0,0,3,1,0,0
Guinea-Bissau,82,3,2005,2000.5,79,126,1,1,1,2,0,0,0,0,1,1
Kazakhstan,80,4,2005,2000.5,76,127,4,5,3,1,0,0,4,4,0,1
Sri Lanka,77,1,2005,2000.5,76,128,1,2,1,0,0,0,1,2,0,0
Botswana,75,7,2005,2000.5,68,129,6,6,2,5,0,1,3,2,3,3
Maldives,75,11,2005,2000.5,64,130,3,1,11,0,2,0,1,0,0,1
Moldova,75,4,2005,2000.5,71,131,3,4,3,1,1,0,1,3,1,1
Armenia,67,8,2005,2000.5,59,132,3,6,3,5,1,1,2,4,0,1
Pakistan,66,6,2005,2000.5,60,133,8,1,6,0,3,0,3,0,2,1
Burundi,62,1,2005,2000.5,61,134,2,1,1,0,0,0,1,1,1,0
Cape Verde,60,5,2005,2000.5,55,135,2,4,1,4,0,1,2,3,0,0
Azerbaijan,59,2,2005,2000.5,57,136,3,8,0,2,0,0,1,8,2,0
Nepal,59,4,2005,2000.5,55,137,1,2,3,1,1,0,0,2,0,0
Tajikistan,59,4,2005,2000.5,55,138,1,1,4,0,1,0,0,1,0,0
Jersey,51,3,2005,2000.5,48,139,1,1,3,0,0,0,0,0,1,1
Central African Republic,37,0,2005,2000.5,37,140,1,1,0,0,0,0,1,1,0,0
Liechtenstein,36,6,2005,2000.5,30,141,4,4,5,1,1,0,2,4,1,0
Nicaragua,35,2,2005,2000.5,33,142,1,2,1,1,1,0,0,2,0,0
Somalia,32,4,2005,2000.5,28,143,2,2,1,3,0,1,2,1,0,0
Réunion,21,2,2005,2000.5,19,144,1,1,1,1,0,0,1,0,0,1
Andorra,20,2,2005,2000.5,18,145,3,5,0,2,0,0,2,4,1,1
Eritrea,19,2,2005,2000.5,17,146,1,2,0,2,0,0,1,1,0,1
Guam,19,1,2005,2000.5,18,147,1,1,0,1,0,0,1,1,0,0
Belize,15,0,2005,2000.5,15,148,1,2,0,0,0,0,1,2,0,0
Mongolia,13,4,2005,2000.5,9,149,1,1,4,0,1,0,0,1,0,0
San Marino,11,1,2005,2000.5,10,150,2,2,1,0,0,0,2,2,0,0
Guernsey,6,3,2005,2000.5,3,151,1,1,0,3,0,0,0,0,1,1
Falkland Islands,1,1,2005,2000.5,0,152,1,1,0,1,0,0,1,1,0,0
Germany,2145,55,2006,2000.6,2090,1,14,4,36,19,11,2,1,1,2,1
Sweden,1730,13,2006,2000.6,1717,2,6,9,9,4,3,2,0,4,3,3
Hungary,1628,8,2006,2000.6,1620,3,4,3,4,4,2,1,2,2,0,0
Brazil,1552,25,2006,2000.6,1527,4,6,6,12,13,5,5,1,0,0,1
England,1478,28,2006,2000.6,1450,5,10,4,24,4,8,1,0,1,2,2
Argentina,1412,16,2006,2000.6,1396,6,6,3,14,2,4,0,2,1,0,2
Netherlands,1213,20,2006,2000.6,1193,7,9,5,13,7,6,3,0,1,3,1
Denmark,1178,16,2006,2000.6,1162,8,4,5,7,9,2,3,0,1,2,1
Austria,1157,12,2006,2000.6,1145,9,7,1,10,2,2,1,4,0,1,0
South Korea,1150,24,2006,2000.6,1126,10,8,11,17,7,4,3,1,5,3,3
France,1130,28,2006,2000.6,1102,11,9,7,17,11,6,5,1,1,2,1
Czech Republic,1115,26,2006,2000.6,1089,12,9,4,17,9,5,2,3,0,1,2
Scotland,1105,15,2006,2000.6,1090,13,3,4,8,7,2,2,1,1,0,1
Italy,1040,25,2006,2000.6,1015,14,11,5,16,9,5,3,1,1,5,1
Poland,1038,21,2006,2000.6,1017,15,8,8,9,12,2,6,5,2,1,0
Belgium,1024,12,2006,2000.6,1012,16,5,4,8,4,2,2,1,1,2,1
Norway,1004,12,2006,2000.6,992,17,4,6,5,7,1,1,0,4,3,1
Mexico,995,14,2006,2000.6,981,18,8,4,11,3,6,0,1,4,1,0
Uruguay,993,13,2006,2000.6,980,19,1,9,4,9,1,4,0,3,0,2
Spain,917,24,2006,2000.6,893,20,10,4,21,3,7,1,2,2,1,1
Switzerland,896,21,2006,2000.6,875,21,8,5,12,9,4,3,1,1,3,1
Russia,894,6,2006,2000.6,888,22,5,2,4,2,2,1,1,0,2,1
Romania,813,16,2006,2000.6,797,23,7,3,11,5,4,3,1,0,2,0
Zambia,787,17,2006,2000.6,770,24,7,8,5,12,3,5,2,2,2,1
Bulgaria,757,12,2006,2000.6,745,25,3,6,5,7,1,3,1,1,1,2
Paraguay,740,10,2006,2000.6,730,26,1,9,2,8,1,1,0,4,0,4
Chile,722,16,2006,2000.6,706,27,6,3,13,3,4,2,1,0,1,1
China,718,9,2006,2000.6,709,28,4,5,4,5,2,1,1,3,1,1
Trinidad and Tobago,716,8,2006,2000.6,708,29,3,8,3,5,1,1,0,7,2,0
Finland,697,11,2006,2000.6,686,30,6,6,5,6,1,2,2,1,3,3
Ghana,687,21,2006,2000.6,666,31,6,11,9,12,4,4,2,5,0,2
Portugal,669,27,2006,2000.6,642,32,7,8,15,12,6,3,1,3,0,2
Saudi Arabia,659,37,2006,2000.6,622,33,18,6,26,11,7,2,6,3,5,1
Wales,654,11,2006,2000.6,643,34,7,1,10,1,3,0,2,1,2,0
Costa Rica,651,8,2006,2000.6,643,35,2,7,2,6,1,0,1,6,0,1
Egypt,647,20,2006,2000.6,627,36,11,2,20,0,7,0,2,1,2,1
Indonesia,633,4,2006,2000.6,629,37,1,3,0,4,0,1,0,1,1,1
Japan,609,28,2006,2000.6,581,38,12,6,19,9,7,2,3,3,2,1
Iraq,602,24,2006,2000.6,578,39,3,11,8,16,2,4,0,5,1,2
Ivory Coast,601,26,2006,2000.6,575,40,5,12,11,15,4,4,1,4,0,4
Malaysia,583,3,2006,2000.6,580,41,3,3,2,1,0,0,1,2,2,1
Ireland,575,11,2006,2000.6,564,42,5,2,9,2,2,0,2,2,1,0
Nigeria,573,10,2006,2000.6,563,43,6,2,8,2,4,2,1,0,1,0
Kuwait,565,17,2006,2000.6,548,44,5,3,15,2,4,0,0,2,1,1
USA,559,20,2006,2000.6,539,45,9,4,16,4,5,1,2,2,2,1
Tunisia,554,19,2006,2000.6,535,46,12,4,17,2,7,0,3,2,2,2
Kenya,552,2,2006,2000.6,550,47,1,4,1,1,0,0,1,3,0,1
Uganda,538,13,2006,2000.6,525,48,6,6,7,6,2,2,0,1,4,3
Northern Ireland,537,7,2006,2000.6,530,49,5,3,5,2,3,1,2,1,0,1
Peru,535,7,2006,2000.6,528,50,2,5,0,7,0,1,2,1,0,3
Australia,534,19,2006,2000.6,515,51,7,6,13,6,5,1,0,3,2,2
Iran,512,18,2006,2000.6,494,52,7,5,14,4,5,0,0,2,2,3
Malawi,502,13,2006,2000.6,489,53,6,5,6,7,2,2,2,2,2,1
Cameroon,496,15,2006,2000.6,481,54,6,2,12,3,4,1,0,1,2,0
Morocco,496,14,2006,2000.6,482,55,7,4,13,1,4,1,2,1,1,2
Turkey,491,22,2006,2000.6,469,56,6,7,11,11,2,4,1,0,3,3
Honduras,483,8,2006,2000.6,475,57,2,4,4,4,2,2,0,1,0,1
Senegal,475,13,2006,2000.6,462,58,4,8,4,9,2,3,1,4,1,1
Greece,470,7,2006,2000.6,463,59,3,6,3,4,2,2,0,3,1,1
Algeria,461,3,2006,2000.6,458,60,5,1,3,0,2,0,2,0,1,1
Jamaica,459,11,2006,2000.6,448,61,5,3,10,1,3,0,1,2,1,1
Colombia,451,8,2006,2000.6,443,62,2,5,3,5,1,2,0,1,1,2
Guinea,444,11,2006,2000.6,433,63,3,5,3,8,1,3,1,1,1,1
Democratic Republic of the Congo,443,8,2006,2000.6,435,64,1,9,3,5,1,1,0,5,0,3
Singapore,443,10,2006,2000.6,433,65,6,8,5,5,1,1,2,5,3,2
Mali,437,4,2006,2000.6,433,66,2,3,2,2,2,2,0,0,0,1
Guatemala,424,6,2006,2000.6,418,67,3,3,4,2,0,0,2,3,1,0
United Arab Emirates,411,17,2006,2000.6,394,68,7,5,10,7,4,2,2,3,1,0
Ecuador,403,10,2006,2000.6,393,69,3,8,5,5,2,1,0,6,1,1
Israel,401,10,2006,2000.6,391,70,3,3,7,3,1,1,2,0,0,2
Zimbabwe,399,9,2006,2000.6,390,71,3,8,4,5,1,2,2,4,0,2
Qatar,393,18,2006,2000.6,375,72,5,3,11,7,5,2,0,1,0,0
New Zealand,381,8,2006,2000.6,373,73,2,6,3,5,2,1,0,4,0,1
Haiti,379,15,2006,2000.6,364,74,6,4,7,8,2,1,2,2,2,1
Myanmar,373,4,2006,2000.6,369,75,1,2,2,2,1,1,0,0,0,1
El Salvador,364,1,2006,2000.6,363,76,1,3,0,1,0,0,0,3,1,0
Latvia,342,4,2006,2000.6,338,77,2,4,4,0,1,0,1,3,0,1
Congo,338,4,2006,2000.6,334,78,1,4,3,1,1,0,0,2,0,2
Iceland,332,4,2006,2000.6,328,79,4,2,1,3,0,1,3,1,1,0
Oman,326,20,2006,2000.6,306,80,7,3,16,4,6,1,0,2,1,0
Syria,324,16,2006,2000.6,308,81,6,7,11,5,3,0,3,3,0,4
Estonia,318,4,2006,2000.6,314,82,4,3,3,1,1,0,2,2,1,1
Martinique,318,7,2006,2000.6,311,83,4,2,3,4,3,1,0,1,1,0
Tanzania,318,17,2006,2000.6,301,84,7,5,10,7,4,3,1,1,2,1
Hong Kong,313,9,2006,2000.6,304,85,7,4,6,3,1,1,3,1,3,2
Sudan,303,18,2006,2000.6,285,86,5,8,12,6,3,2,1,3,1,3
Bahrain,300,5,2006,2000.6,295,87,5,4,4,1,1,0,3,2,1,2
Ethiopia,297,12,2006,2000.6,285,88,9,1,12,0,7,0,2,1,0,0
Togo,292,8,2006,2000.6,284,89,5,10,3,5,1,2,3,7,1,1
India,290,4,2006,2000.6,286,90,3,4,0,4,0,0,3,3,0,1
Cuba,267,25,2006,2000.6,242,91,4,4,22,3,4,2,0,0,0,2
Burkina Faso,262,4,2006,2000.6,258,92,1,5,1,3,1,1,0,2,0,2
Croatia,261,31,2006,2000.6,230,93,5,10,13,18,2,5,1,3,2,2
Gabon,256,10,2006,2000.6,246,94,1,6,4,6,1,1,0,2,0,3
Canada,253,4,2006,2000.6,249,95,1,4,1,3,1,1,0,2,0,1
Lithuania,253,12,2006,2000.6,241,96,1,7,1,11,0,4,1,2,0,1
Suriname,253,4,2006,2000.6,249,97,2,4,1,3,1,1,1,2,0,1
Libya,248,11,2006,2000.6,237,98,7,9,8,3,2,1,2,7,3,1
Angola,241,25,2006,2000.6,216,99,6,11,13,12,3,3,2,4,1,4
Panama,236,7,2006,2000.6,229,100,2,4,2,5,1,2,1,1,0,1
South Africa,222,5,2006,2000.6,217,101,3,8,1,4,1,3,1,3,1,2
Jordan,212,21,2006,2000.6,191,102,9,8,14,7,5,2,2,4,2,2
Serbia,209,14,2006,2000.6,195,103,6,5,7,7,3,2,1,2,2,1
Slovakia,209,23,2006,2000.6,186,104,6,3,14,9,3,3,2,0,1,0
Cyprus,208,10,2006,2000.6,198,105,4,3,8,2,2,0,1,3,1,0
Uzbekistan,206,14,2006,2000.6,192,106,3,3,9,5,2,1,0,1,1,1
Grenada,183,4,2006,2000.6,179,107,1,4,0,4,0,0,1,1,0,3
Guadeloupe,182,16,2006,2000.6,166,108,4,3,8,8,4,2,0,1,0,0
Mozambique,181,5,2006,2000.6,176,109,3,3,5,0,1,0,1,1,1,2
Mauritius,172,4,2006,2000.6,168,110,3,3,1,3,0,0,1,3,2,0
Barbados,169,21,2006,2000.6,148,111,5,2,13,8,2,2,0,0,3,0
Lebanon,169,7,2006,2000.6,162,112,4,1,5,2,1,1,0,0,3,0
Venezuela,160,5,2006,2000.6,155,113,4,5,4,1,2,1,0,4,2,0
Ukraine,157,26,2006,2000.6,131,114,6,8,19,7,6,2,0,3,0,3
Malta,156,3,2006,2000.6,153,115,3,3,3,0,1,0,2,3,0,0
St. Kitts and Nevis,155,13,2006,2000.6,142,116,1,3,6,7,1,1,0,1,0,1
Slovenia,154,9,2006,2000.6,145,117,5,3,6,3,2,1,2,2,1,0
Albania,152,7,2006,2000.6,145,118,3,3,1,6,0,1,2,1,1,1
Vietnam,148,7,2006,2000.6,141,119,1,3,2,5,1,1,0,2,0,0
Georgia,144,14,2006,2000.6,130,120,5,5,4,10,1,2,4,2,0,1
Liberia,143,4,2006,2000.6,139,121,1,1,3,1,1,0,0,1,0,0
Sierra Leone,142,0,2006,2000.6,142,122,1,1,0,0,0,0,0,1,1,0
Benin,133,3,2006,2000.6,130,123,1,2,2,1,1,0,0,2,0,0
Belarus,130,14,2006,2000.6,116,124,3,7,9,5,2,0,0,5,1,2
Macedonia,130,7,2006,2000.6,123,125,4,4,2,5,1,3,3,0,0,1
Antigua and Barbuda,128,12,2006,2000.6,116,126,6,4,10,2,3,0,2,4,1,0
Guyana,124,35,2006,2000.6,89,127,7,3,24,11,7,3,0,0,0,0
Madagascar,123,0,2006,2000.6,123,128,1,2,0,0,0,0,1,2,0,0
St. Lucia,122,4,2006,2000.6,118,129,1,4,1,3,0,0,1,4,0,0
Luxembourg,120,0,2006,2000.6,120,130,8,2,0,0,0,0,6,2,2,0
Yemen,113,12,2006,2000.6,101,131,7,4,9,3,3,1,3,3,1,0
Gambia,112,2,2006,2000.6,110,132,1,1,2,0,1,0,0,1,0,0
Namibia,111,9,2006,2000.6,102,133,4,2,5,4,2,0,1,2,1,0
Bermuda,106,8,2006,2000.6,98,134,1,2,3,5,1,1,0,0,0,1
Swaziland,104,8,2006,2000.6,96,135,3,8,4,4,1,1,2,5,0,2
Dominica,100,0,2006,2000.6,100,136,3,2,0,0,0,0,2,2,1,0
Bangladesh,99,8,2006,2000.6,91,137,7,3,8,0,2,0,4,3,1,0
Cambodia,98,6,2006,2000.6,92,138,3,2,5,1,1,0,1,2,1,0
Niger,98,1,2006,2000.6,97,139,1,2,0,1,0,0,0,1,1,1
Lesotho,95,9,2006,2000.6,86,140,6,3,8,1,1,0,2,3,3,0
Rwanda,95,8,2006,2000.6,87,141,5,5,1,7,0,2,3,2,2,1
Palestine,93,24,2006,2000.6,69,142,5,7,12,12,2,3,3,2,0,2
Kazakhstan,89,9,2006,2000.6,80,143,5,8,5,4,2,0,3,3,0,5
Faroe Islands,86,0,2006,2000.6,86,144,2,3,0,0,0,0,2,3,0,0
Sri Lanka,84,7,2006,2000.6,77,145,5,1,6,1,2,1,1,0,2,0
Botswana,80,5,2006,2000.6,75,146,6,4,4,1,3,0,0,2,3,2
Tajikistan,80,21,2006,2000.6,59,147,3,7,6,15,2,3,1,4,0,0
Moldova,78,3,2006,2000.6,75,148,3,2,3,0,1,0,1,2,1,0
Pakistan,73,7,2006,2000.6,66,149,6,4,4,3,0,1,5,3,1,0
Burundi,69,7,2006,2000.6,62,150,3,1,6,1,2,0,1,1,0,0
Armenia,67,0,2006,2000.6,67,151,2,4,0,0,0,0,1,4,1,0
Nepal,64,5,2006,2000.6,59,152,1,3,2,3,1,0,0,1,0,2
Cape Verde,62,2,2006,2000.6,60,153,1,2,1,1,1,0,0,2,0,0
Azerbaijan,61,2,2006,2000.6,59,154,3,5,2,0,0,0,0,4,3,1
Cayman Islands,49,1,2006,2000.6,48,155,1,2,0,1,0,0,1,2,0,0
Kyrgyzstan,48,8,2006,2000.6,40,156,2,7,1,7,1,4,1,3,0,0
Dominican Republic,47,5,2006,2000.6,42,157,2,4,2,3,1,0,1,4,0,0
Chad,43,4,2006,2000.6,39,158,3,2,2,2,0,0,1,1,2,1
Liechtenstein,39,3,2006,2000.6,36,159,4,4,1,2,0,0,4,4,0,0
Somalia,35,3,2006,2000.6,32,160,3,3,2,1,0,0,3,3,0,0
Philippines,34,3,2006,2000.6,31,161,3,1,3,0,1,0,1,1,1,0
Macau,27,2,2006,2000.6,25,162,3,2,0,2,0,0,2,1,1,1
Equatorial Guinea,24,7,2006,2000.6,17,163,5,1,7,0,3,0,0,1,2,0
Seychelles,23,7,2006,2000.6,16,164,4,2,6,1,3,0,1,1,0,1
Andorra,21,1,2006,2000.6,20,165,1,4,0,1,0,0,1,4,0,0
Eritrea,21,2,2006,2000.6,19,166,1,1,0,2,0,1,0,0,1,0
Anguilla,19,5,2006,2000.6,14,167,1,2,1,4,0,0,1,2,0,0
Bahamas,16,7,2006,2000.6,9,168,2,3,3,4,1,1,1,2,0,0
Greenland,15,0,2006,2000.6,15,169,1,2,0,0,0,0,1,2,0,0
Djibouti,14,3,2006,2000.6,11,170,2,3,2,1,0,0,2,3,0,0
San Marino,11,0,2006,2000.6,11,171,2,2,0,0,0,0,2,2,0,0
Brunei,10,2,2006,2000.6,8,172,1,2,2,0,1,0,0,1,0,1
Bhutan,8,0,2006,2000.6,8,173,2,1,0,0,0,0,1,1,1,0
Afghanistan,7,3,2006,2000.6,4,174,1,1,2,1,0,0,0,0,1,1
Turks and Caicos Islands,4,4,2006,2000.6,0,175,1,2,2,2,0,1,1,1,0,0
Germany,2169,24,2007,2000.7,2145,1,8,4,18,6,5,3,2,0,1,1
Sweden,1750,20,2007,2000.7,1730,2,5,9,9,11,3,3,0,5,2,1
Hungary,1641,13,2007,2000.7,1628,3,4,8,8,5,3,2,1,6,0,0
Brazil,1590,38,2007,2000.7,1552,4,8,10,19,19,7,4,1,1,0,5
England,1499,21,2007,2000.7,1478,5,7,5,13,8,3,3,3,1,1,1
Argentina,1444,32,2007,2000.7,1412,6,7,9,18,14,6,5,0,3,1,1
Netherlands,1231,18,2007,2000.7,1213,7,5,7,9,9,4,4,0,3,1,0
Denmark,1197,19,2007,2000.7,1178,8,6,6,11,8,3,3,3,2,0,1
Austria,1164,7,2007,2000.7,1157,9,9,3,5,2,1,0,3,2,5,1
South Korea,1159,9,2007,2000.7,1150,10,6,5,6,3,2,2,2,1,2,2
France,1148,18,2007,2000.7,1130,11,7,5,8,10,4,3,2,0,1,2
Czech Republic,1132,17,2007,2000.7,1115,12,4,6,6,11,3,4,1,0,0,2
Scotland,1119,14,2007,2000.7,1105,13,5,5,10,4,4,3,1,2,0,0
Poland,1064,26,2007,2000.7,1038,14,7,6,17,9,5,1,1,1,1,4
Italy,1058,18,2007,2000.7,1040,15,5,5,9,9,4,4,0,1,1,0
Belgium,1034,10,2007,2000.7,1024,16,5,5,7,3,2,1,2,3,1,1
Mexico,1034,39,2007,2000.7,995,17,19,4,35,4,12,1,5,3,2,0
Norway,1025,21,2007,2000.7,1004,18,5,4,13,8,3,2,1,1,1,1
Uruguay,1016,23,2007,2000.7,993,19,4,10,9,14,1,5,1,3,2,2
Spain,938,21,2007,2000.7,917,20,5,7,9,12,5,5,0,0,0,2
Switzerland,911,15,2007,2000.7,896,21,7,3,11,4,3,1,3,2,1,0
Russia,910,16,2007,2000.7,894,22,4,6,11,5,3,2,0,3,1,1
Romania,837,24,2007,2000.7,813,23,6,6,16,8,6,3,0,2,0,1
Zambia,801,14,2007,2000.7,787,24,2,9,4,10,1,3,0,2,1,4
Bulgaria,773,16,2007,2000.7,757,25,5,6,6,10,3,4,1,1,1,1
Paraguay,762,22,2007,2000.7,740,26,4,12,12,10,3,3,0,6,1,3
China,742,24,2007,2000.7,718,27,5,5,14,10,3,2,1,3,1,0
Chile,741,19,2007,2000.7,722,28,6,13,9,10,3,4,2,5,1,4
Trinidad and Tobago,736,20,2007,2000.7,716,29,7,7,15,5,4,0,1,5,2,2
Finland,703,6,2007,2000.7,697,30,6,4,6,0,3,0,1,1,2,3
Ghana,701,14,2007,2000.7,687,31,3,5,7,7,2,2,0,2,1,1
Saudi Arabia,693,34,2007,2000.7,659,32,10,8,23,11,9,4,0,2,1,2
Portugal,688,19,2007,2000.7,669,33,6,6,10,9,3,3,0,0,3,3
Costa Rica,679,28,2007,2000.7,651,34,11,8,20,8,6,1,1,2,4,5
Wales,670,16,2007,2000.7,654,35,5,7,7,9,1,3,1,2,3,2
Thailand,659,37,2007,2000.7,622,36,16,4,26,11,8,2,2,1,6,1
Egypt,656,9,2007,2000.7,647,37,3,5,6,3,3,0,0,1,0,4
Indonesia,648,15,2007,2000.7,633,38,8,3,12,3,4,0,4,1,0,2
Japan,634,25,2007,2000.7,609,39,8,5,14,11,4,3,1,0,3,2
Iraq,626,24,2007,2000.7,602,40,7,13,7,17,3,4,2,3,2,6
Ivory Coast,622,21,2007,2000.7,601,41,3,6,6,15,2,3,0,2,1,1
Malaysia,598,15,2007,2000.7,583,42,10,3,13,2,2,0,5,2,3,1
Ireland,590,15,2007,2000.7,575,43,4,7,3,12,2,2,0,1,2,4
USA,587,28,2007,2000.7,559,44,12,5,25,3,9,2,2,3,1,0
Nigeria,585,12,2007,2000.7,573,45,3,7,4,8,2,3,1,2,0,2
Kuwait,571,6,2007,2000.7,565,46,4,1,4,2,0,0,1,1,3,0
Tunisia,570,16,2007,2000.7,554,47,4,5,9,7,3,2,0,1,1,2
Kenya,565,13,2007,2000.7,552,48,6,6,8,5,4,0,2,2,0,4
Uganda,558,20,2007,2000.7,538,49,6,6,14,6,3,2,1,3,2,1
Northern Ireland,550,13,2007,2000.7,537,50,4,5,7,6,3,1,0,3,1,1
Australia,549,15,2007,2000.7,534,51,5,5,4,11,1,3,3,1,1,1
Peru,549,14,2007,2000.7,535,52,5,9,7,7,1,2,0,6,4,1
Iran,534,22,2007,2000.7,512,53,6,6,14,8,3,4,0,1,3,1
Honduras,517,34,2007,2000.7,483,54,7,10,11,23,4,5,2,4,1,1
Malawi,509,7,2007,2000.7,502,55,4,3,3,4,0,1,3,2,1,0
Morocco,508,12,2007,2000.7,496,56,5,3,8,4,3,1,1,0,1,2
Cameroon,505,9,2007,2000.7,496,57,2,4,5,4,2,1,0,2,0,1
Turkey,505,14,2007,2000.7,491,58,4,6,5,9,1,2,1,2,2,2
Senegal,497,22,2007,2000.7,475,59,5,5,17,5,5,1,0,1,0,3
Greece,488,18,2007,2000.7,470,60,6,4,12,6,3,3,3,0,0,1
Colombia,475,24,2007,2000.7,451,61,10,7,15,9,8,2,1,2,1,3
Singapore,475,32,2007,2000.7,443,62,10,5,24,8,4,1,2,1,4,3
Algeria,474,13,2007,2000.7,461,63,6,2,10,3,3,0,3,1,0,1
Jamaica,469,10,2007,2000.7,459,64,5,4,6,4,2,1,2,3,1,0
Guinea,459,15,2007,2000.7,444,65,2,6,6,9,1,3,0,2,1,1
Mali,457,20,2007,2000.7,437,66,3,6,10,10,2,3,0,2,1,1
Democratic Republic of the Congo,451,8,2007,2000.7,443,67,3,4,6,2,2,0,0,2,1,2
United Arab Emirates,436,25,2007,2000.7,411,68,12,7,17,8,5,3,5,2,2,2
Guatemala,433,9,2007,2000.7,424,69,4,11,3,6,3,2,1,5,0,4
Ecuador,430,27,2007,2000.7,403,70,10,8,20,7,5,0,3,8,2,0
Israel,416,15,2007,2000.7,401,71,6,5,10,5,4,2,0,3,2,0
Qatar,413,20,2007,2000.7,393,72,11,6,15,5,3,1,6,1,2,4
Zimbabwe,406,7,2007,2000.7,399,73,4,4,6,1,1,1,0,1,3,2
Haiti,403,24,2007,2000.7,379,74,7,9,9,15,4,5,1,2,2,2
New Zealand,391,10,2007,2000.7,381,75,1,5,4,6,1,2,0,2,0,1
Myanmar,376,3,2007,2000.7,373,76,4,3,2,1,2,0,1,1,1,2
El Salvador,375,11,2007,2000.7,364,77,12,4,10,1,4,0,5,4,3,0
Syria,357,33,2007,2000.7,324,78,4,9,14,19,3,7,1,2,0,0
Latvia,354,12,2007,2000.7,342,79,7,5,6,6,2,1,5,4,0,0
Bolivia,353,9,2007,2000.7,344,80,4,8,1,8,0,1,1,5,3,2
Congo,351,13,2007,2000.7,338,81,6,4,11,2,3,1,0,1,3,2
Oman,350,24,2007,2000.7,326,82,10,9,14,10,5,4,1,2,4,3
Iceland,339,7,2007,2000.7,332,83,5,4,7,0,1,0,1,4,3,0
Hong Kong,331,18,2007,2000.7,313,84,4,2,18,0,2,0,0,2,2,0
Tanzania,328,10,2007,2000.7,318,85,9,3,8,2,4,1,2,1,3,1
Martinique,325,7,2007,2000.7,318,86,1,3,3,4,1,1,0,2,0,0
Estonia,323,5,2007,2000.7,318,87,5,9,2,3,1,1,4,6,0,2
Sudan,323,20,2007,2000.7,303,88,6,7,11,9,5,4,0,1,1,2
Bahrain,322,22,2007,2000.7,300,89,6,8,13,9,4,1,1,5,1,2
Togo,307,15,2007,2000.7,292,90,4,4,8,7,2,2,1,2,1,0
India,306,16,2007,2000.7,290,91,6,1,15,1,4,0,1,1,1,0
Ethiopia,301,4,2007,2000.7,297,92,3,2,3,1,1,0,1,2,1,0
Croatia,281,20,2007,2000.7,261,93,6,4,10,10,5,3,0,1,1,0
Cuba,275,8,2007,2000.7,267,94,4,6,3,5,1,0,2,5,1,1
Canada,269,16,2007,2000.7,253,95,3,7,5,11,1,3,1,2,1,2
Gabon,268,12,2007,2000.7,256,96,2,6,0,12,0,3,1,0,1,3
Burkina Faso,267,5,2007,2000.7,262,97,3,4,1,4,0,0,2,3,1,1
Lithuania,264,11,2007,2000.7,253,98,7,4,8,3,4,1,3,3,0,0
Angola,260,19,2007,2000.7,241,99,6,5,13,6,4,1,1,2,1,2
Libya,255,7,2007,2000.7,248,100,3,6,5,2,2,0,0,4,1,2
Panama,255,19,2007,2000.7,236,101,9,9,14,5,5,0,1,5,3,4
Uzbekistan,239,33,2007,2000.7,206,102,4,11,12,21,2,3,0,7,2,1
South Africa,236,14,2007,2000.7,222,103,8,6,8,6,3,2,3,2,2,2
Slovakia,232,23,2007,2000.7,209,104,4,7,11,12,1,2,2,4,1,1
Serbia,225,16,2007,2000.7,209,105,4,6,4,12,1,2,0,2,3,2
Jordan,224,12,2007,2000.7,212,106,6,3,6,6,2,2,2,1,2,0
Cyprus,222,14,2007,2000.7,208,107,7,4,12,2,4,1,3,2,0,1
New Caledonia,219,21,2007,2000.7,198,108,6,3,14,7,4,2,1,0,1,1
Guadeloupe,198,16,2007,2000.7,182,109,6,7,9,7,1,3,2,4,3,0
Fiji,195,27,2007,2000.7,168,110,5,3,26,1,3,0,1,2,1,1
Venezuela,191,31,2007,2000.7,160,111,14,4,28,3,7,1,3,2,4,1
Mozambique,188,7,2007,2000.7,181,112,6,2,5,2,2,1,1,0,3,1
Lebanon,176,7,2007,2000.7,169,113,2,3,4,3,1,0,1,1,0,2
Mauritius,175,3,2007,2000.7,172,114,5,3,3,0,0,0,3,2,2,1
Ukraine,173,16,2007,2000.7,157,115,5,6,11,5,3,1,1,3,1,2
Barbados,172,3,2007,2000.7,169,116,2,2,2,1,0,0,1,1,1,1
Vietnam,170,22,2007,2000.7,148,117,9,4,22,0,4,0,3,2,2,2
Albania,164,12,2007,2000.7,152,118,7,4,8,4,2,1,3,1,2,2
Malta,163,7,2007,2000.7,156,119,6,5,6,1,0,0,4,4,2,1
St. Kitts and Nevis,162,7,2007,2000.7,155,120,1,3,3,4,1,1,0,2,0,0
Slovenia,161,7,2007,2000.7,154,121,6,5,3,4,2,1,3,2,1,2
Georgia,155,11,2007,2000.7,144,122,5,7,7,4,3,1,1,4,1,2
Solomon Islands,151,25,2007,2000.7,126,123,5,2,20,5,3,2,2,0,0,0
Benin,146,13,2007,2000.7,133,124,5,4,7,6,2,1,1,2,2,1
Belarus,145,15,2007,2000.7,130,125,5,6,5,10,2,2,3,3,0,1
Liberia,145,2,2007,2000.7,143,126,2,2,1,1,0,0,1,2,1,0
Sierra Leone,145,3,2007,2000.7,142,127,3,5,1,2,1,0,2,4,0,1
Madagascar,140,17,2007,2000.7,123,128,7,2,13,4,2,1,3,1,2,0
Macedonia,139,9,2007,2000.7,130,129,5,4,7,2,2,1,1,3,2,0
Antigua and Barbuda,130,2,2007,2000.7,128,130,1,1,2,0,1,0,0,1,0,0
Luxembourg,124,4,2007,2000.7,120,131,6,5,3,1,1,1,4,4,1,0
Yemen,124,11,2007,2000.7,113,132,3,5,8,3,2,0,0,4,1,1
Namibia,123,12,2007,2000.7,111,133,3,9,3,9,1,3,1,6,1,0
Gambia,119,7,2007,2000.7,112,134,3,5,4,3,2,0,1,2,0,3
Rwanda,118,23,2007,2000.7,95,135,5,6,9,14,4,2,1,3,0,1
Vanuatu,118,32,2007,2000.7,86,136,2,8,1,31,0,5,2,3,0,0
Bermuda,113,7,2007,2000.7,106,137,4,3,5,2,1,1,3,2,0,0
Swaziland,106,2,2007,2000.7,104,138,6,3,1,1,1,1,2,2,3,0
Kazakhstan,105,16,2007,2000.7,89,139,9,5,12,4,3,1,2,4,4,0
Lesotho,105,10,2007,2000.7,95,140,5,6,8,2,2,1,2,4,1,1
Cambodia,104,6,2007,2000.7,98,141,2,5,1,5,0,0,2,4,0,1
Niger,104,6,2007,2000.7,98,142,2,3,3,3,1,0,1,2,0,1
Turkmenistan,104,9,2007,2000.7,95,143,2,4,7,2,2,1,0,2,0,1
Bangladesh,101,2,2007,2000.7,99,144,4,2,2,0,0,0,2,2,2,0
Palestine,93,0,2007,2000.7,93,145,2,1,0,0,0,0,2,1,0,0
Tajikistan,92,12,2007,2000.7,80,146,3,4,8,4,1,0,1,2,1,2
Faroe Islands,90,4,2007,2000.7,86,147,4,4,1,3,0,0,4,4,0,0
Moldova,89,11,2007,2000.7,78,148,4,5,5,6,1,2,1,3,2,0
Botswana,85,5,2007,2000.7,80,149,7,3,5,0,4,0,0,3,3,0
Guinea-Bissau,85,3,2007,2000.7,82,150,3,1,3,0,1,0,0,1,2,0
Sri Lanka,84,0,2007,2000.7,84,151,1,1,0,0,0,0,1,1,0,0
Burundi,78,9,2007,2000.7,69,152,5,6,4,5,2,2,2,3,1,1
Maldives,77,2,2007,2000.7,75,153,1,2,2,0,1,0,0,2,0,0
Armenia,74,7,2007,2000.7,67,154,4,8,2,5,1,2,1,4,2,2
Pakistan,73,0,2007,2000.7,73,155,1,1,0,0,0,0,1,0,0,1
Azerbaijan,72,11,2007,2000.7,61,156,8,6,6,5,3,1,4,3,1,2
Cape Verde,65,3,2007,2000.7,62,157,3,3,2,1,0,0,0,2,3,1
Nepal,64,0,2007,2000.7,64,158,1,1,0,0,0,0,1,1,0,0
Mauritania,60,4,2007,2000.7,56,159,2,3,3,1,1,0,0,2,1,1
Kyrgyzstan,58,10,2007,2000.7,48,160,3,6,6,4,2,1,1,5,0,0
Jersey,53,2,2007,2000.7,51,161,2,1,2,0,1,0,0,0,1,1
Chad,50,7,2007,2000.7,43,162,4,3,5,2,1,1,2,1,1,1
Liechtenstein,47,8,2007,2000.7,39,163,5,4,5,3,2,0,3,3,0,1
Nicaragua,41,6,2007,2000.7,35,164,2,3,5,1,1,0,1,3,0,0
Eritrea,35,14,2007,2000.7,21,165,5,8,7,7,3,1,0,6,2,1
Somalia,35,0,2007,2000.7,35,166,1,3,0,0,0,0,1,3,0,0
Guam,34,15,2007,2000.7,19,167,2,3,9,6,1,1,1,2,0,0
Tonga,33,6,2007,2000.7,27,168,2,2,5,1,1,0,1,2,0,0
Equatorial Guinea,31,7,2007,2000.7,24,169,4,3,6,1,2,0,0,2,2,1
Macau,30,3,2007,2000.7,27,170,2,2,1,2,0,0,1,2,1,0
Seychelles,26,3,2007,2000.7,23,171,3,4,2,1,1,0,2,3,0,1
Andorra,22,1,2007,2000.7,21,172,6,3,0,1,0,0,5,3,1,0
Réunion,22,1,2007,2000.7,21,173,2,2,0,1,0,0,2,1,0,1
Mongolia,18,5,2007,2000.7,13,174,1,1,5,0,1,0,0,0,0,1
Djibouti,17,3,2007,2000.7,14,175,3,1,3,0,1,0,2,1,0,0
Cook Islands,15,4,2007,2000.7,11,176,1,2,4,0,1,0,0,2,0,0
Gibraltar,13,3,2007,2000.7,10,177,1,1,2,1,1,0,0,0,0,1
San Marino,13,2,2007,2000.7,11,178,5,4,2,0,0,0,5,4,0,0
Åland Islands,11,0,2007,2000.7,11,179,1,1,0,0,0,0,1,1,0,0
Afghanistan,8,1,2007,2000.7,7,180,1,1,1,0,0,0,1,1,0,0
Montenegro,5,5,2007,2000.7,0,181,3,3,4,1,1,1,1,2,1,0
American Samoa,4,1,2007,2000.7,3,182,1,3,0,1,0,0,1,3,0,0
Tuvalu,4,1,2007,2000.7,3,183,1,2,0,1,0,0,1,2,0,0
Comoros,2,2,2007,2000.7,0,184,1,1,0,2,0,0,1,1,0,0
Northern Mariana Islands,2,2,2007,2000.7,0,185,1,1,2,0,0,0,1,1,0,0
Germany,2205,36,2008,2000.8,2169,1,9,7,15,21,6,5,2,1,1,1
Sweden,1760,10,2008,2000.8,1750,2,6,8,6,4,2,2,3,4,1,2
Hungary,1655,14,2008,2000.8,1641,3,7,3,10,4,2,2,1,1,4,0
Brazil,1608,18,2008,2000.8,1590,4,6,4,10,8,3,3,1,1,2,0
England,1524,25,2008,2000.8,1499,5,4,6,11,14,3,5,0,1,1,0
Argentina,1456,12,2008,2000.8,1444,6,3,7,4,8,1,3,0,1,2,3
Netherlands,1264,33,2008,2000.8,1231,7,10,5,22,11,7,4,2,0,1,1
Denmark,1208,11,2008,2000.8,1197,8,4,5,4,7,1,2,2,0,1,3
Austria,1183,19,2008,2000.8,1164,9,10,3,16,3,2,0,6,1,2,2
South Korea,1183,24,2008,2000.8,1159,10,6,5,14,10,4,4,1,0,1,1
France,1164,16,2008,2000.8,1148,11,8,6,9,7,5,1,1,3,2,2
Czech Republic,1149,17,2008,2000.8,1132,12,5,7,7,10,3,2,2,2,0,3
Scotland,1123,4,2008,2000.8,1119,13,4,3,1,3,0,1,1,2,3,0
Poland,1082,18,2008,2000.8,1064,14,6,10,6,12,2,5,2,3,2,2
Italy,1076,18,2008,2000.8,1058,15,6,7,13,5,4,2,0,2,2,3
Mexico,1061,27,2008,2000.8,1034,16,8,6,19,8,6,2,2,2,0,2
Belgium,1044,10,2008,2000.8,1034,17,4,4,7,3,2,0,2,2,0,2
Uruguay,1037,21,2008,2000.8,1016,18,4,7,9,12,1,3,0,1,3,3
Norway,1031,6,2008,2000.8,1025,19,4,4,5,1,0,0,1,3,3,1
Spain,970,32,2008,2000.8,938,20,8,7,16,16,7,7,0,0,1,0
Russia,936,26,2008,2000.8,910,21,7,6,16,10,5,3,1,3,1,0
Switzerland,932,21,2008,2000.8,911,22,10,3,16,5,6,1,4,1,0,1
Romania,851,14,2008,2000.8,837,23,7,4,12,2,4,1,1,2,2,1
Zambia,819,18,2008,2000.8,801,24,4,12,5,13,3,3,0,6,1,3
Trinidad and Tobago,793,57,2008,2000.8,736,25,20,10,42,15,13,4,3,2,4,4
Bulgaria,779,6,2008,2000.8,773,26,2,4,2,4,1,1,0,1,1,2
Paraguay,774,12,2008,2000.8,762,27,3,10,5,7,3,2,0,3,0,5
China,758,16,2008,2000.8,742,28,9,9,10,6,2,2,4,3,3,4
Chile,755,14,2008,2000.8,741,29,5,9,7,7,3,4,1,4,1,1
Ghana,726,25,2008,2000.8,701,30,11,6,20,5,8,1,2,4,1,1
Saudi Arabia,725,32,2008,2000.8,693,31,14,4,27,5,10,2,1,2,3,0
Finland,712,9,2008,2000.8,703,32,5,4,7,2,2,0,1,4,2,0
Portugal,712,24,2008,2000.8,688,33,7,6,14,10,3,2,3,3,1,1
Costa Rica,699,20,2008,2000.8,679,34,4,7,6,14,3,3,1,1,0,3
Egypt,692,36,2008,2000.8,656,35,11,6,27,9,9,3,1,2,1,1
Thailand,692,33,2008,2000.8,659,36,9,8,23,10,5,1,4,3,0,4
Wales,682,12,2008,2000.8,670,37,4,6,7,5,3,3,1,3,0,0
Indonesia,673,25,2008,2000.8,648,38,9,3,21,4,6,1,2,2,1,0
Japan,661,27,2008,2000.8,634,39,11,6,16,11,5,4,1,1,5,1
Ivory Coast,655,33,2008,2000.8,622,40,9,9,22,11,6,3,2,2,1,4
Iraq,636,10,2008,2000.8,626,41,4,8,3,7,1,2,1,4,2,2
Malaysia,626,28,2008,2000.8,598,42,7,4,25,3,5,0,1,2,1,2
USA,617,30,2008,2000.8,587,43,7,7,23,7,5,4,0,3,2,0
Nigeria,602,17,2008,2000.8,585,44,7,6,12,5,5,3,1,2,1,1
Ireland,598,8,2008,2000.8,590,45,5,3,5,3,2,1,2,0,1,2
Tunisia,594,24,2008,2000.8,570,46,10,6,18,6,4,3,3,1,3,2
Kuwait,585,14,2008,2000.8,571,47,7,8,11,3,2,0,3,5,2,3
Kenya,573,8,2008,2000.8,565,48,3,4,5,3,3,0,0,2,0,2
Australia,567,18,2008,2000.8,549,49,6,7,11,7,4,4,1,1,1,2
Uganda,567,9,2008,2000.8,558,50,4,3,7,2,3,0,0,2,1,1
Iran,563,29,2008,2000.8,534,51,12,8,21,8,8,3,1,1,3,4
Northern Ireland,559,9,2008,2000.8,550,52,5,3,8,1,2,0,2,2,1,1
Peru,557,8,2008,2000.8,549,53,4,6,6,2,2,0,0,6,2,0
Morocco,543,35,2008,2000.8,508,54,7,7,19,16,7,3,0,3,0,1
Honduras,540,23,2008,2000.8,517,55,8,4,19,4,8,0,0,2,0,2
Cameroon,535,30,2008,2000.8,505,56,6,7,17,13,5,4,1,2,0,1
Malawi,529,20,2008,2000.8,509,57,4,8,11,9,3,4,1,3,0,1
Turkey,528,23,2008,2000.8,505,58,6,9,8,15,3,4,1,2,2,3
Senegal,515,18,2008,2000.8,497,59,6,6,10,8,3,1,1,1,2,4
Greece,509,21,2008,2000.8,488,60,8,6,10,11,3,4,4,1,1,1
Jamaica,506,37,2008,2000.8,469,61,12,6,32,5,9,1,0,2,3,3
Singapore,497,22,2008,2000.8,475,62,7,10,13,9,3,3,3,4,1,3
Guinea,486,27,2008,2000.8,459,63,7,8,18,9,4,3,1,3,2,2
Colombia,485,10,2008,2000.8,475,64,5,8,6,4,2,0,3,4,0,4
Algeria,484,10,2008,2000.8,474,65,6,3,10,0,4,0,0,2,2,1
Mali,472,15,2008,2000.8,457,66,4,8,10,5,4,1,0,5,0,2
Democratic Republic of the Congo,468,17,2008,2000.8,451,67,4,5,8,9,3,1,1,2,0,2
Guatemala,452,19,2008,2000.8,433,68,8,6,14,5,4,1,2,3,2,2
United Arab Emirates,452,16,2008,2000.8,436,69,10,7,9,7,1,1,5,2,4,4
Ecuador,442,12,2008,2000.8,430,70,4,8,7,5,3,2,0,4,1,2
Qatar,436,23,2008,2000.8,413,71,13,9,18,5,5,3,4,5,4,1
Israel,428,12,2008,2000.8,416,72,4,4,6,6,2,2,0,1,2,1
Haiti,420,17,2008,2000.8,403,73,9,12,7,10,1,4,2,6,6,2
Zimbabwe,415,9,2008,2000.8,406,74,4,7,3,6,2,1,0,4,2,2
El Salvador,406,31,2008,2000.8,375,75,8,12,22,9,3,4,2,4,3,4
Myanmar,406,30,2008,2000.8,376,76,7,9,15,15,5,4,1,5,1,0
New Zealand,397,6,2008,2000.8,391,77,1,2,3,3,1,1,0,1,0,0
Syria,378,21,2008,2000.8,357,78,7,12,6,15,3,3,1,6,3,3
Oman,376,26,2008,2000.8,350,79,17,4,23,3,9,1,3,2,5,1
Latvia,368,14,2008,2000.8,354,80,4,6,4,10,2,3,1,2,1,1
Bolivia,367,14,2008,2000.8,353,81,7,4,12,2,4,1,2,2,1,1
Congo,358,7,2008,2000.8,351,82,3,3,4,3,3,0,0,3,0,0
Iceland,352,13,2008,2000.8,339,83,5,7,6,7,2,3,2,3,1,1
Bahrain,350,28,2008,2000.8,322,84,13,8,17,11,6,5,4,2,3,1
Tanzania,341,13,2008,2000.8,328,85,6,4,7,6,2,1,0,3,4,0
Estonia,337,14,2008,2000.8,323,86,10,3,12,2,4,0,2,3,4,0
Sudan,337,14,2008,2000.8,323,87,7,8,10,4,3,1,3,6,1,1
Martinique,334,9,2008,2000.8,325,88,4,4,5,4,1,2,2,1,1,1
India,330,24,2008,2000.8,306,89,12,1,23,1,8,1,1,0,3,0
Togo,317,10,2008,2000.8,307,90,4,3,8,2,3,0,1,3,0,0
Cuba,309,34,2008,2000.8,275,91,11,6,26,8,5,2,3,3,3,1
Ethiopia,309,8,2008,2000.8,301,92,2,2,7,1,1,1,1,1,0,0
Croatia,300,19,2008,2000.8,281,93,7,6,12,7,4,3,2,0,1,3
Curaçao,299,10,2008,2000.8,289,94,7,5,7,3,3,1,3,3,1,1
Burkina Faso,282,15,2008,2000.8,267,95,4,4,6,9,2,3,1,1,1,0
Angola,281,21,2008,2000.8,260,96,4,10,9,12,2,2,0,4,2,4
Gabon,280,12,2008,2000.8,268,97,6,3,9,3,4,1,0,2,2,0
Canada,279,10,2008,2000.8,269,98,2,7,3,7,0,1,0,5,2,1
Lithuania,279,15,2008,2000.8,264,99,5,7,8,7,4,2,1,3,0,2
Libya,278,23,2008,2000.8,255,100,8,4,21,2,6,1,0,2,2,1
Suriname,276,23,2008,2000.8,253,101,5,9,5,18,2,3,2,4,1,2
Uzbekistan,261,22,2008,2000.8,239,102,5,7,13,9,4,2,1,4,0,1
Panama,260,5,2008,2000.8,255,103,2,4,3,2,1,1,0,2,1,1
South Africa,259,23,2008,2000.8,236,104,11,6,18,5,7,1,2,3,2,2
Slovakia,246,14,2008,2000.8,232,105,5,5,9,5,3,1,2,3,0,1
Jordan,244,20,2008,2000.8,224,106,6,10,11,9,4,1,2,5,0,4
Serbia,244,19,2008,2000.8,225,107,4,7,11,8,3,1,1,4,0,2
Cyprus,228,6,2008,2000.8,222,108,3,4,4,2,1,0,1,3,1,1
New Caledonia,228,9,2008,2000.8,219,109,5,2,8,1,2,0,2,1,1,1
Guadeloupe,223,25,2008,2000.8,198,110,5,7,13,12,3,3,2,1,0,3
Venezuela,210,19,2008,2000.8,191,111,10,6,13,6,4,2,3,3,3,1
Grenada,207,24,2008,2000.8,183,112,5,10,15,9,4,2,0,6,1,2
Mozambique,205,17,2008,2000.8,188,113,5,9,10,7,2,4,2,4,1,1
Fiji,200,5,2008,2000.8,195,114,2,1,4,1,2,0,0,1,0,0
Barbados,193,21,2008,2000.8,172,115,5,11,8,13,3,3,2,6,0,2
Lebanon,189,13,2008,2000.8,176,116,3,9,5,8,1,1,2,7,0,1
Vietnam,184,14,2008,2000.8,170,117,6,4,9,5,1,2,1,2,4,0
Ukraine,183,10,2008,2000.8,173,118,5,4,5,5,4,2,0,1,1,1
Mauritius,181,6,2008,2000.8,175,119,6,4,3,3,0,0,5,3,1,1
St. Kitts and Nevis,174,12,2008,2000.8,162,120,4,4,9,3,1,0,2,3,1,1
Malta,173,10,2008,2000.8,163,121,7,4,8,2,2,0,5,4,0,0
Albania,170,6,2008,2000.8,164,122,4,3,5,1,2,0,1,1,1,2
Slovenia,170,9,2008,2000.8,161,123,4,4,7,2,2,1,2,2,0,1
Antigua and Barbuda,169,39,2008,2000.8,130,124,8,9,22,17,6,3,1,4,1,2
Georgia,163,8,2008,2000.8,155,125,4,6,3,5,0,1,2,4,2,1
Benin,162,16,2008,2000.8,146,126,4,8,10,6,3,1,1,7,0,0
Belarus,159,14,2008,2000.8,145,127,4,7,5,9,1,2,1,3,2,2
Liberia,156,11,2008,2000.8,145,128,4,6,6,5,1,1,0,5,3,0
Sierra Leone,150,5,2008,2000.8,145,129,3,4,3,2,2,0,1,3,0,1
Madagascar,149,9,2008,2000.8,140,130,8,4,7,2,2,1,2,2,4,1
Macedonia,148,9,2008,2000.8,139,131,4,3,4,5,1,1,1,2,2,0
Namibia,139,16,2008,2000.8,123,132,5,10,9,7,2,2,3,6,0,2
Guyana,134,10,2008,2000.8,124,133,6,7,7,3,1,0,2,6,3,1
Bermuda,131,18,2008,2000.8,113,134,7,4,6,12,2,3,4,0,1,1
Luxembourg,131,7,2008,2000.8,124,135,7,2,4,3,0,1,4,1,3,0
Yemen,128,4,2008,2000.8,124,136,2,3,3,1,1,0,0,2,1,1
Rwanda,127,9,2008,2000.8,118,137,2,5,6,3,2,2,0,2,0,1
St. Lucia,127,5,2008,2000.8,122,138,2,3,3,2,1,0,1,3,0,0
Gambia,125,6,2008,2000.8,119,139,3,3,4,2,2,0,0,1,1,2
Vanuatu,123,5,2008,2000.8,118,140,2,3,3,2,1,1,0,2,1,0
Cambodia,117,13,2008,2000.8,104,141,6,4,11,2,3,0,3,4,0,0
Lesotho,115,10,2008,2000.8,105,142,6,7,3,7,0,2,5,3,1,2
Swaziland,115,9,2008,2000.8,106,143,5,6,6,3,1,1,1,3,3,2
Turkmenistan,114,10,2008,2000.8,104,144,3,6,1,9,0,2,2,4,1,0
Niger,111,7,2008,2000.8,104,145,3,4,4,3,1,0,2,4,0,0
Kazakhstan,110,5,2008,2000.8,105,146,3,6,4,1,1,0,2,5,0,1
Bangladesh,105,4,2008,2000.8,101,147,5,3,3,1,0,0,2,2,3,1
Tajikistan,105,13,2008,2000.8,92,148,2,6,7,6,2,1,0,2,0,3
Sri Lanka,104,20,2008,2000.8,84,149,6,3,11,9,3,1,2,1,1,1
Dominica,102,2,2008,2000.8,100,150,3,2,2,0,0,0,2,2,1,0
Moldova,95,6,2008,2000.8,89,151,4,6,5,1,0,1,2,4,2,1
Botswana,94,9,2008,2000.8,85,152,6,6,2,7,1,2,3,4,2,0
Faroe Islands,94,4,2008,2000.8,90,153,2,5,1,3,0,0,1,5,1,0
Palestine,94,1,2008,2000.8,93,154,2,1,1,0,0,0,1,1,1,0
Pakistan,89,16,2008,2000.8,73,155,3,5,11,5,1,1,2,4,0,0
Maldives,87,10,2008,2000.8,77,156,4,3,8,2,2,2,2,1,0,0
Burundi,83,5,2008,2000.8,78,157,4,3,2,3,1,1,2,2,1,0
Armenia,80,6,2008,2000.8,74,158,5,4,3,3,2,1,2,2,1,1
Nepal,80,16,2008,2000.8,64,159,5,7,10,6,3,2,1,5,1,0
Azerbaijan,78,6,2008,2000.8,72,160,3,7,1,5,0,2,0,4,3,1
Cape Verde,74,9,2008,2000.8,65,161,3,5,5,4,2,2,1,2,0,1
Aruba,69,1,2008,2000.8,68,162,1,3,0,1,0,0,1,2,0,1
Mauritania,63,3,2008,2000.8,60,163,3,3,1,2,0,0,3,3,0,0
Kyrgyzstan,60,2,2008,2000.8,58,164,2,1,2,0,1,0,1,1,0,0
Cayman Islands,58,9,2008,2000.8,49,165,6,3,5,4,1,0,3,2,2,1
Chad,57,7,2008,2000.8,50,166,3,4,4,3,1,1,2,3,0,0
Dominican Republic,48,1,2008,2000.8,47,167,2,2,1,0,0,0,2,2,0,0
Liechtenstein,48,1,2008,2000.8,47,168,1,6,0,1,0,0,1,5,0,1
Laos,47,7,2008,2000.8,40,169,1,5,3,4,1,1,0,4,0,0
British Virgin Islands,44,4,2008,2000.8,40,170,1,3,1,3,0,0,1,1,0,2
Philippines,43,9,2008,2000.8,34,171,4,2,5,4,2,1,1,0,1,1
Nicaragua,41,0,2008,2000.8,41,172,1,1,0,0,0,0,1,1,0,0
Seychelles,38,12,2008,2000.8,26,173,4,5,3,9,0,1,4,3,0,1
Puerto Rico,35,8,2008,2000.8,27,174,3,3,5,3,1,2,0,1,2,0
Equatorial Guinea,34,3,2008,2000.8,31,175,3,2,2,1,1,0,2,2,0,0
Macau,34,4,2008,2000.8,30,176,2,2,1,3,0,0,2,2,0,0
Andorra,24,2,2008,2000.8,22,177,4,2,2,0,0,0,4,2,0,0
St. Martin,23,2,2008,2000.8,21,178,1,2,0,2,0,0,1,2,0,0
Djibouti,21,4,2008,2000.8,17,179,3,4,2,2,0,0,3,4,0,0
Anguilla,20,1,2008,2000.8,19,180,1,2,0,1,0,0,1,2,0,0
Bahamas,19,3,2008,2000.8,16,181,2,2,3,0,0,0,0,2,2,0
Belize,19,4,2008,2000.8,15,182,3,3,3,1,1,0,2,2,0,1
Montenegro,19,14,2008,2000.8,5,183,5,3,10,4,3,0,0,2,2,1
Afghanistan,16,8,2008,2000.8,8,184,3,7,1,7,0,1,3,2,0,4
Bhutan,15,7,2008,2000.8,8,185,1,6,1,6,0,1,0,4,1,1
Brunei,15,5,2008,2000.8,10,186,1,5,1,4,0,0,0,4,1,1
San Marino,14,1,2008,2000.8,13,187,3,1,1,0,0,0,3,1,0,0
Taiwan,8,8,2008,2000.8,0,188,2,2,6,2,1,0,0,1,1,1
Turks and Caicos Islands,6,2,2008,2000.8,4,189,1,1,2,0,1,0,0,1,0,0
Mayotte,3,3,2008,2000.8,0,190,1,1,1,2,0,0,1,1,0,0
Germany,2231,26,2009,2000.9,2205,1,6,5,13,13,3,4,1,0,2,1
Sweden,1777,17,2009,2000.9,1760,2,4,9,9,8,3,4,1,4,0,1
Hungary,1661,6,2009,2000.9,1655,3,4,5,4,2,1,2,3,3,0,0
Brazil,1637,29,2009,2000.9,1608,4,5,8,9,20,4,8,0,0,1,0
England,1552,28,2009,2000.9,1524,5,6,5,22,6,6,1,0,3,0,1
Argentina,1476,20,2009,2000.9,1456,6,6,5,13,7,5,3,1,2,0,0
Netherlands,1282,18,2009,2000.9,1264,7,6,5,14,4,4,2,0,0,2,3
Denmark,1223,15,2009,2000.9,1208,8,7,4,9,6,3,2,2,0,2,2
South Korea,1198,15,2009,2000.9,1183,9,7,5,9,6,4,1,1,0,2,4
Austria,1193,10,2009,2000.9,1183,10,6,3,8,2,3,0,3,2,0,1
France,1180,16,2009,2000.9,1164,11,8,4,12,4,4,3,2,0,2,1
Czech Republic,1165,16,2009,2000.9,1149,12,6,5,14,2,4,0,1,1,1,4
Scotland,1127,4,2009,2000.9,1123,13,3,4,4,0,2,0,1,4,0,0
Mexico,1104,43,2009,2000.9,1061,14,13,8,28,15,9,3,2,3,2,2
Poland,1101,19,2009,2000.9,1082,15,6,7,14,5,3,1,2,4,1,2
Italy,1099,23,2009,2000.9,1076,16,8,7,14,9,5,3,1,2,2,2
Belgium,1056,12,2009,2000.9,1044,17,5,5,10,2,4,0,0,5,1,0
Uruguay,1048,11,2009,2000.9,1037,18,4,6,3,8,1,3,2,2,1,1
Norway,1045,14,2009,2000.9,1031,19,4,6,10,4,4,2,0,2,0,2
Spain,1012,42,2009,2000.9,970,20,7,8,14,28,6,8,1,0,0,0
Russia,953,17,2009,2000.9,936,21,5,5,9,8,3,3,2,1,0,1
Switzerland,944,12,2009,2000.9,932,22,6,3,5,7,2,2,1,0,3,1
Romania,863,12,2009,2000.9,851,23,4,6,7,5,1,3,2,2,1,1
Zambia,835,16,2009,2000.9,819,24,4,12,2,14,1,5,2,5,1,2
Trinidad and Tobago,807,14,2009,2000.9,793,25,6,6,7,7,2,1,2,4,2,1
Bulgaria,800,21,2009,2000.9,779,26,5,5,14,7,4,1,0,2,1,2
China,788,30,2009,2000.9,758,27,9,6,22,8,6,1,1,2,2,3
Paraguay,780,6,2009,2000.9,774,28,4,7,1,5,1,2,3,4,0,1
Chile,777,22,2009,2000.9,755,29,4,8,9,13,3,5,0,2,1,1
Saudi Arabia,754,29,2009,2000.9,725,30,8,10,16,13,4,5,0,2,4,3
Ghana,743,17,2009,2000.9,726,31,4,6,10,7,3,1,0,3,1,2
Costa Rica,736,37,2009,2000.9,699,32,13,10,21,16,7,4,3,3,3,3
Portugal,729,17,2009,2000.9,712,33,5,5,10,7,4,3,0,0,1,2
Finland,725,13,2009,2000.9,712,34,3,8,4,9,2,2,1,4,0,2
Egypt,720,28,2009,2000.9,692,35,10,5,22,6,6,3,1,2,3,0
Thailand,705,13,2009,2000.9,692,36,6,3,9,4,3,1,1,1,2,1
Japan,701,40,2009,2000.9,661,37,11,6,34,6,9,2,0,3,2,1
Wales,692,10,2009,2000.9,682,38,6,4,5,5,2,2,4,2,0,0
Ivory Coast,679,24,2009,2000.9,655,39,4,6,15,9,4,2,0,0,0,4
Indonesia,676,3,2009,2000.9,673,40,2,3,1,2,0,0,0,2,2,1
USA,660,43,2009,2000.9,617,41,15,9,29,14,9,4,4,4,2,1
Iraq,649,13,2009,2000.9,636,42,6,8,10,3,3,1,0,5,3,2
Malaysia,638,12,2009,2000.9,626,43,6,3,10,2,2,0,2,2,2,1
Ireland,610,12,2009,2000.9,598,44,8,4,7,5,2,1,2,0,4,3
Nigeria,610,8,2009,2000.9,602,45,3,4,3,5,1,2,0,0,2,2
Kuwait,607,22,2009,2000.9,585,46,13,7,13,9,4,3,5,1,4,3
Tunisia,605,11,2009,2000.9,594,47,6,3,7,4,2,1,1,1,3,1
Uganda,595,28,2009,2000.9,567,48,8,4,22,6,8,3,0,1,0,0
Kenya,591,18,2009,2000.9,573,49,11,7,16,2,5,1,5,5,1,1
Iran,588,25,2009,2000.9,563,50,10,10,17,8,6,1,1,5,3,4
Australia,580,13,2009,2000.9,567,51,6,6,7,6,4,2,1,1,1,3
Honduras,579,39,2009,2000.9,540,52,15,9,33,6,12,3,3,5,0,1
Northern Ireland,568,9,2009,2000.9,559,53,5,4,5,4,2,1,2,1,1,2
Peru,562,5,2009,2000.9,557,54,3,4,2,3,2,1,1,3,0,0
Cameroon,550,15,2009,2000.9,535,55,3,6,8,7,3,3,0,2,0,1
Morocco,549,6,2009,2000.9,543,56,5,3,2,4,0,1,2,1,3,1
Turkey,541,13,2009,2000.9,528,57,5,4,10,3,3,1,1,3,1,0
Malawi,540,11,2009,2000.9,529,58,6,6,8,3,3,1,2,4,1,1
Greece,522,13,2009,2000.9,509,59,5,5,10,3,3,1,0,2,2,2
Jamaica,517,11,2009,2000.9,506,60,3,8,5,6,1,3,1,1,1,4
Singapore,512,15,2009,2000.9,497,61,6,3,12,3,3,1,2,1,1,1
Colombia,501,16,2009,2000.9,485,62,7,4,12,4,5,2,2,2,0,0
Guinea,495,9,2009,2000.9,486,63,2,5,2,7,0,0,2,4,0,1
Algeria,494,10,2009,2000.9,484,64,5,3,8,2,5,1,0,1,0,1
Mali,486,14,2009,2000.9,472,65,3,4,6,8,3,1,0,0,0,3
Democratic Republic of the Congo,473,5,2009,2000.9,468,66,1,3,1,4,0,1,1,1,0,1
United Arab Emirates,468,16,2009,2000.9,452,67,9,5,9,7,2,1,5,2,2,2
Qatar,456,20,2009,2000.9,436,68,9,10,12,8,5,2,0,6,4,2
Guatemala,455,3,2009,2000.9,452,69,3,4,2,1,1,0,2,3,0,1
Ecuador,449,7,2009,2000.9,442,70,3,4,3,4,1,1,1,3,1,0
Israel,442,14,2009,2000.9,428,71,5,3,12,2,3,0,1,1,1,2
Haiti,428,8,2009,2000.9,420,72,4,7,4,4,1,0,1,5,2,2
El Salvador,427,21,2009,2000.9,406,73,11,11,12,9,4,2,3,9,4,0
Zimbabwe,427,12,2009,2000.9,415,74,5,4,10,2,3,0,0,3,2,1
Myanmar,413,7,2009,2000.9,406,75,2,1,5,2,2,1,0,0,0,0
Syria,407,29,2009,2000.9,378,76,8,9,17,12,5,5,1,2,2,2
New Zealand,406,9,2009,2000.9,397,77,2,8,1,8,1,1,1,4,0,3
Oman,394,18,2009,2000.9,376,78,11,4,12,6,5,2,3,1,3,1
Bahrain,391,41,2009,2000.9,350,79,15,7,35,6,11,2,1,4,3,1
Latvia,383,15,2009,2000.9,368,80,4,5,7,8,2,2,0,3,2,0
Bolivia,369,2,2009,2000.9,367,81,2,5,1,1,0,0,2,5,0,0
Iceland,364,12,2009,2000.9,352,82,6,5,8,4,2,1,2,3,2,1
Tanzania,361,20,2009,2000.9,341,83,7,9,11,9,4,2,2,6,1,1
Estonia,348,11,2009,2000.9,337,84,7,5,6,5,3,1,2,3,2,1
Hong Kong,346,15,2009,2000.9,331,85,4,2,15,0,2,0,2,2,0,0
Sudan,342,5,2009,2000.9,337,86,5,5,4,1,1,0,3,4,1,1
India,337,7,2009,2000.9,330,87,5,1,6,1,2,0,2,1,1,0
Togo,322,5,2009,2000.9,317,88,4,6,3,2,2,0,1,4,1,2
Croatia,321,21,2009,2000.9,300,89,4,5,11,10,3,4,0,1,1,0
Ethiopia,314,5,2009,2000.9,309,90,2,1,5,0,1,0,1,1,0,0
Burkina Faso,293,11,2009,2000.9,282,91,4,4,8,3,2,2,1,2,1,0
Gabon,290,10,2009,2000.9,280,92,3,4,6,4,2,1,1,2,0,1
Angola,288,7,2009,2000.9,281,93,10,2,3,4,0,2,4,0,6,0
Lithuania,288,9,2009,2000.9,279,94,4,5,3,6,1,2,2,3,1,0
Canada,287,8,2009,2000.9,279,95,2,6,1,7,1,3,1,2,0,1
Libya,281,3,2009,2000.9,278,96,1,1,2,1,0,0,1,0,0,1
Panama,277,17,2009,2000.9,260,97,5,9,10,7,3,1,2,5,0,3
Uzbekistan,273,12,2009,2000.9,261,98,5,5,7,5,2,2,2,2,1,1
South Africa,269,10,2009,2000.9,259,99,13,5,10,0,5,0,5,5,3,0
Slovakia,267,21,2009,2000.9,246,100,6,6,13,8,2,3,3,2,1,1
Serbia,266,22,2009,2000.9,244,101,5,7,9,13,3,6,1,1,1,0
Jordan,254,10,2009,2000.9,244,102,6,6,5,5,2,0,1,5,3,1
Cyprus,244,16,2009,2000.9,228,103,7,4,12,4,3,0,3,3,1,1
Guadeloupe,228,5,2009,2000.9,223,104,2,2,3,2,1,1,1,1,0,0
Venezuela,223,13,2009,2000.9,210,105,5,7,8,5,2,2,1,3,2,2
Mozambique,212,7,2009,2000.9,205,106,6,4,5,2,4,1,2,3,0,0
Grenada,209,2,2009,2000.9,207,107,1,4,2,0,0,0,0,4,1,0
Ukraine,204,21,2009,2000.9,183,108,5,7,8,13,3,3,2,1,0,3
Lebanon,197,8,2009,2000.9,189,109,3,7,1,7,0,1,2,5,1,1
Vietnam,192,8,2009,2000.9,184,110,4,3,6,2,2,1,1,1,1,1
Slovenia,186,16,2009,2000.9,170,111,4,6,9,7,3,2,0,4,1,0
Mauritius,181,0,2009,2000.9,181,112,1,2,0,0,0,0,1,2,0,0
Albania,180,10,2009,2000.9,170,113,5,4,9,1,1,0,2,2,2,2
Belarus,177,18,2009,2000.9,159,114,5,5,12,6,2,1,1,3,2,1
Malta,177,4,2009,2000.9,173,115,7,4,4,0,1,0,5,4,1,0
Antigua and Barbuda,173,4,2009,2000.9,169,116,1,1,2,2,1,0,0,0,0,1
Georgia,171,8,2009,2000.9,163,117,3,7,1,7,0,0,2,6,1,1
Benin,168,6,2009,2000.9,162,118,3,2,3,3,1,1,0,1,2,0
Macedonia,160,12,2009,2000.9,148,119,6,4,10,2,3,0,1,3,2,1
Madagascar,153,4,2009,2000.9,149,120,1,2,2,2,1,0,0,1,0,1
Namibia,145,6,2009,2000.9,139,121,4,2,5,1,1,0,1,0,2,2
Rwanda,137,10,2009,2000.9,127,122,8,7,7,3,3,1,3,6,2,0
Yemen,137,9,2009,2000.9,128,123,4,5,6,3,3,0,0,5,1,0
Guyana,136,2,2009,2000.9,134,124,1,1,1,1,1,0,0,1,0,0
Luxembourg,133,2,2009,2000.9,131,125,4,4,1,1,0,0,3,3,1,1
Turkmenistan,132,18,2009,2000.9,114,126,1,6,5,13,1,2,0,4,0,0
Sri Lanka,129,25,2009,2000.9,104,127,7,5,20,5,4,0,1,5,2,0
Swaziland,124,9,2009,2000.9,115,128,4,4,7,2,2,0,0,3,2,1
Lesotho,121,6,2009,2000.9,115,129,1,6,0,6,0,1,0,1,1,4
Kazakhstan,118,8,2009,2000.9,110,130,3,4,2,6,0,2,3,2,0,0
Moldova,108,13,2009,2000.9,95,131,3,7,1,12,0,2,1,3,2,2
Maldives,106,19,2009,2000.9,87,132,6,1,18,1,4,0,1,0,1,1
Pakistan,105,16,2009,2000.9,89,133,2,5,8,8,1,1,0,2,1,2
Faroe Islands,100,6,2009,2000.9,94,134,3,4,2,4,1,1,2,3,0,0
Botswana,99,5,2009,2000.9,94,135,3,6,2,3,1,1,0,2,2,3
Burundi,91,8,2009,2000.9,83,136,3,5,1,7,1,1,2,3,0,1
Nepal,90,10,2009,2000.9,80,137,4,2,6,4,2,1,0,0,2,1
Armenia,86,6,2009,2000.9,80,138,4,3,6,0,1,0,2,2,1,1
Azerbaijan,86,8,2009,2000.9,78,139,7,6,5,3,1,1,4,4,2,1
Cape Verde,83,9,2009,2000.9,74,140,1,3,5,4,1,2,0,0,0,1
Kyrgyzstan,68,8,2009,2000.9,60,141,2,5,2,6,0,1,0,3,2,1
Liechtenstein,50,2,2009,2000.9,48,142,6,4,1,1,0,0,5,4,1,0
Macau,47,13,2009,2000.9,34,143,4,4,10,3,2,0,2,3,0,1
Nicaragua,46,5,2009,2000.9,41,144,3,4,3,2,1,0,1,3,1,1
Philippines,46,3,2009,2000.9,43,145,1,2,1,2,1,0,0,2,0,0
Seychelles,40,2,2009,2000.9,38,146,2,1,1,1,0,0,2,1,0,0
Guam,39,5,2009,2000.9,34,147,3,1,5,0,2,0,0,1,1,0
Somalia,37,2,2009,2000.9,35,148,2,3,2,0,1,0,1,3,0,0
Montenegro,28,9,2009,2000.9,19,149,5,4,6,3,3,0,1,1,1,3
Andorra,27,3,2009,2000.9,24,150,4,3,2,1,0,0,4,3,0,0
Mongolia,27,9,2009,2000.9,18,151,1,4,3,6,1,2,0,2,0,0
Djibouti,23,2,2009,2000.9,21,152,3,3,1,1,0,0,2,3,1,0
Belize,22,3,2009,2000.9,19,153,1,2,1,2,0,0,1,1,0,1
Afghanistan,17,1,2009,2000.9,16,154,1,1,0,1,0,0,1,1,0,0
Bhutan,16,1,2009,2000.9,15,155,1,5,0,1,0,0,1,5,0,0
Brunei,16,1,2009,2000.9,15,156,1,1,0,1,0,0,1,1,0,0
San Marino,14,0,2009,2000.9,14,157,2,4,0,0,0,0,2,4,0,0
Mayotte,5,2,2009,2000.9,3,158,1,1,2,0,0,0,0,1,1,0
Northern Mariana Islands,5,3,2009,2000.9,2,159,1,2,1,2,0,0,1,2,0,0
Comoros,4,2,2009,2000.9,2,160,1,2,0,2,0,1,0,1,1,0
Germany,2268,37,2010,2010,2231,1,8,8,20,17,5,6,3,0,0,2
Sweden,1793,16,2010,2010,1777,2,4,5,11,5,3,3,0,1,1,1
Hungary,1678,17,2010,2010,1661,3,5,4,13,4,3,1,1,3,1,0
Brazil,1661,24,2010,2010,1637,4,3,8,8,16,3,5,0,2,0,1
England,1573,21,2010,2010,1552,5,8,4,14,7,4,3,1,1,3,0
Argentina,1507,31,2010,2010,1476,6,10,4,27,4,9,3,1,1,0,0
Netherlands,1322,40,2010,2010,1282,7,12,5,28,12,11,4,1,0,0,1
Denmark,1235,12,2010,2010,1223,8,6,6,8,4,3,1,1,5,2,0
South Korea,1226,28,2010,2010,1198,9,6,13,11,17,4,6,1,6,1,1
Austria,1205,12,2010,2010,1193,10,6,1,8,4,3,0,3,0,0,1
France,1191,11,2010,2010,1180,11,7,5,6,5,3,1,4,2,0,2
Czech Republic,1177,12,2010,2010,1165,12,3,5,5,7,2,2,1,2,0,1
Scotland,1135,8,2010,2010,1127,13,4,3,8,0,3,0,1,2,0,1
Mexico,1132,28,2010,2010,1104,14,13,6,20,8,7,2,2,3,4,1
Poland,1121,20,2010,2010,1101,15,7,5,13,7,3,1,2,1,2,3
Italy,1116,17,2010,2010,1099,16,8,4,12,5,2,1,2,1,4,2
Uruguay,1079,31,2010,2010,1048,17,6,7,11,20,2,6,2,1,2,0
Belgium,1068,12,2010,2010,1056,18,4,4,6,6,1,2,2,2,1,0
Norway,1058,13,2010,2010,1045,19,4,5,5,8,3,4,1,1,0,0
Spain,1044,32,2010,2010,1012,20,7,10,16,16,6,7,1,2,0,1
Russia,961,8,2010,2010,953,21,3,4,1,7,1,3,2,0,0,1
Switzerland,955,11,2010,2010,944,22,8,4,9,2,1,2,3,2,4,0
Romania,870,7,2010,2010,863,23,4,5,4,3,1,0,2,3,1,2
Zambia,854,19,2010,2010,835,24,6,8,12,7,2,3,1,4,3,1
Trinidad and Tobago,820,13,2010,2010,807,25,4,9,7,6,2,3,2,4,0,2
China,809,21,2010,2010,788,26,11,5,16,5,6,3,2,1,3,1
Bulgaria,805,5,2010,2010,800,27,3,6,2,3,1,1,2,4,0,1
Paraguay,801,21,2010,2010,780,28,6,9,5,16,1,4,1,3,4,2
Chile,797,20,2010,2010,777,29,9,6,15,5,7,3,1,3,1,0
Saudi Arabia,770,16,2010,2010,754,30,7,8,6,10,3,3,1,3,3,2
Ghana,757,14,2010,2010,743,31,7,10,3,11,2,5,2,3,3,2
Portugal,751,22,2010,2010,729,32,7,5,16,6,4,2,0,2,3,1
Egypt,748,28,2010,2010,720,33,8,5,21,7,7,2,0,3,1,0
Costa Rica,744,8,2010,2010,736,34,1,9,2,6,1,1,0,6,0,2
Finland,738,13,2010,2010,725,35,4,5,10,3,2,1,2,3,0,1
Japan,719,18,2010,2010,701,36,13,5,12,6,6,2,5,1,2,2
Thailand,714,9,2010,2010,705,37,7,4,6,3,3,1,1,3,3,0
Indonesia,700,24,2010,2010,676,38,10,2,24,0,8,0,2,2,0,0
Ivory Coast,698,19,2010,2010,679,39,6,8,8,11,2,5,2,2,2,1
Wales,698,6,2010,2010,692,40,3,3,5,1,1,0,2,3,0,0
USA,679,19,2010,2010,660,41,9,5,11,8,3,2,4,1,2,2
Iraq,671,22,2010,2010,649,42,6,9,8,14,3,5,1,2,2,2
Malaysia,651,13,2010,2010,638,43,4,6,11,2,4,0,0,4,0,2
Kuwait,650,43,2010,2010,607,44,11,10,23,20,6,4,1,1,4,5
Nigeria,628,18,2010,2010,610,45,8,7,15,3,5,0,0,6,3,1
Ireland,623,13,2010,2010,610,46,7,2,11,2,3,1,4,0,0,1
Tunisia,623,18,2010,2010,605,47,4,7,4,14,0,3,2,1,2,3
Uganda,613,18,2010,2010,595,48,4,8,8,10,3,2,0,0,1,6
Iran,606,18,2010,2010,588,49,5,5,7,11,3,4,2,0,0,1
Kenya,600,9,2010,2010,591,50,2,8,1,8,0,1,1,6,1,1
Australia,593,13,2010,2010,580,51,6,7,8,5,5,1,1,3,0,3
Honduras,592,13,2010,2010,579,52,3,12,2,11,1,2,2,5,0,5
Cameroon,573,23,2010,2010,550,53,6,10,8,15,1,3,3,4,2,3
Northern Ireland,571,3,2010,2010,568,54,3,5,1,2,0,1,1,3,2,1
Peru,569,7,2010,2010,562,55,1,4,2,5,1,2,0,1,0,1
Malawi,561,21,2010,2010,540,56,6,7,16,5,4,0,0,4,2,3
Turkey,556,15,2010,2010,541,57,4,6,9,6,4,2,0,4,0,0
Morocco,553,4,2010,2010,549,58,2,2,2,2,1,1,0,0,1,1
Jamaica,537,20,2010,2010,517,59,7,6,9,11,5,3,1,2,1,1
Greece,531,9,2010,2010,522,60,7,4,6,3,3,2,3,1,1,1
Senegal,531,16,2010,2010,515,61,2,5,8,8,2,3,0,2,0,0
Singapore,523,11,2010,2010,512,62,4,6,8,3,2,0,1,5,1,1
Colombia,508,7,2010,2010,501,63,2,6,2,5,1,1,0,2,1,3
Guinea,503,8,2010,2010,495,64,1,3,1,7,1,2,0,1,0,0
Algeria,501,7,2010,2010,494,65,6,10,3,4,1,2,4,5,1,3
Mali,499,13,2010,2010,486,66,5,5,8,5,3,0,2,3,0,2
United Arab Emirates,484,16,2010,2010,468,67,8,4,12,4,4,2,3,1,1,1
Democratic Republic of the Congo,482,9,2010,2010,473,68,2,4,2,7,0,0,2,3,0,1
Guatemala,472,17,2010,2010,455,69,4,4,12,5,3,2,1,2,0,0
Qatar,467,11,2010,2010,456,70,8,3,8,3,2,1,2,2,4,0
Ecuador,457,8,2010,2010,449,71,2,5,6,2,1,1,0,3,1,1
Israel,453,11,2010,2010,442,72,3,5,7,4,2,1,1,3,0,1
Zimbabwe,433,6,2010,2010,427,73,3,5,2,4,1,1,1,3,1,1
El Salvador,432,5,2010,2010,427,74,3,3,3,2,0,0,2,3,1,0
Haiti,429,1,2010,2010,428,75,1,4,0,1,0,1,0,2,1,1
Syria,426,19,2010,2010,407,76,6,8,12,7,2,2,3,3,1,3
Myanmar,421,8,2010,2010,413,77,1,6,0,8,0,2,0,4,1,0
Bahrain,415,24,2010,2010,391,78,9,10,16,8,4,1,3,6,2,3
New Zealand,412,6,2010,2010,406,79,4,5,3,3,1,0,1,3,2,2
Oman,408,14,2010,2010,394,80,9,7,7,7,2,2,3,3,4,2
Latvia,388,5,2010,2010,383,81,3,8,1,4,0,1,2,4,1,3
Iceland,375,11,2010,2010,364,82,5,4,9,2,2,0,2,2,1,2
Tanzania,371,10,2010,2010,361,83,10,1,9,1,3,0,5,0,2,1
Bolivia,370,1,2010,2010,369,84,1,1,1,0,0,0,0,1,1,0
Congo,361,3,2010,2010,358,85,1,2,3,0,1,0,0,2,0,0
Estonia,361,13,2010,2010,348,86,8,5,9,4,2,1,2,4,4,0
Hong Kong,347,1,2010,2010,346,87,3,4,0,1,0,1,2,3,1,0
India,347,10,2010,2010,337,88,6,3,10,0,2,0,4,3,0,0
Sudan,347,5,2010,2010,342,89,4,1,5,0,1,0,1,0,2,1
Martinique,345,11,2010,2010,334,90,4,6,1,10,0,2,2,1,2,3
Croatia,336,15,2010,2010,321,91,4,6,7,8,3,4,0,0,1,2
Togo,327,5,2010,2010,322,92,3,5,2,3,0,0,1,4,2,1
Ethiopia,325,11,2010,2010,314,93,5,3,7,4,2,2,3,1,0,0
Cuba,324,15,2010,2010,309,94,3,6,5,10,1,4,1,0,1,2
Curaçao,309,10,2010,2010,299,95,3,2,7,3,1,0,1,1,1,1
Burkina Faso,302,9,2010,2010,293,96,5,1,9,0,3,0,1,0,1,1
Gabon,301,11,2010,2010,290,97,5,5,7,4,2,2,2,2,1,1
Angola,299,11,2010,2010,288,98,8,3,9,2,2,1,2,2,4,0
South Africa,295,26,2010,2010,269,99,14,2,25,1,9,0,2,0,3,2
Suriname,295,19,2010,2010,276,100,5,3,11,8,3,1,1,1,1,1
Panama,293,16,2010,2010,277,101,7,3,12,4,5,1,1,2,1,0
Canada,292,5,2010,2010,287,102,2,4,2,3,1,0,1,2,0,2
Lithuania,292,4,2010,2010,288,103,4,4,2,2,1,1,1,3,2,0
Libya,285,4,2010,2010,281,104,3,2,4,0,2,0,0,1,1,1
Serbia,284,18,2010,2010,266,105,6,8,6,12,1,5,3,3,2,0
Uzbekistan,282,9,2010,2010,273,106,1,6,0,9,0,1,1,3,0,2
Slovakia,281,14,2010,2010,267,107,8,4,10,4,3,1,2,2,3,1
Jordan,266,12,2010,2010,254,108,7,2,11,1,3,0,1,1,3,1
Cyprus,250,6,2010,2010,244,109,3,3,2,4,1,0,1,1,1,2
Guadeloupe,250,22,2010,2010,228,110,7,6,10,12,4,4,1,1,2,1
Venezuela,234,11,2010,2010,223,111,4,7,3,8,1,2,2,2,1,3
New Caledonia,229,1,2010,2010,228,112,1,1,0,1,0,0,1,0,0,1
Ukraine,220,16,2010,2010,204,113,5,4,12,4,3,1,0,1,2,2
Grenada,219,10,2010,2010,209,114,6,3,8,2,3,0,2,1,1,2
Mozambique,218,6,2010,2010,212,115,6,4,5,1,1,1,3,3,2,0
Slovenia,206,20,2010,2010,186,116,8,3,17,3,4,2,3,0,1,1
Vietnam,205,13,2010,2010,192,117,6,4,10,3,2,0,2,3,2,1
Barbados,200,7,2010,2010,193,118,2,1,2,5,0,1,1,0,1,0
Lebanon,198,1,2010,2010,197,119,1,1,1,0,0,0,0,1,1,0
Belarus,192,15,2010,2010,177,120,5,5,5,10,2,4,1,0,2,1
Albania,186,6,2010,2010,180,121,5,3,4,2,4,1,0,1,1,1
St. Kitts and Nevis,186,12,2010,2010,174,122,4,4,9,3,2,1,1,2,1,1
Antigua and Barbuda,183,10,2010,2010,173,123,6,3,8,2,3,0,1,2,2,1
Mauritius,182,1,2010,2010,181,124,1,1,1,0,0,0,1,1,0,0
Malta,180,3,2010,2010,177,125,3,4,2,1,0,0,2,4,1,0
Georgia,178,7,2010,2010,171,126,4,4,3,4,2,1,0,0,2,3
Benin,175,7,2010,2010,168,127,3,5,2,5,1,1,0,3,2,1
Macedonia,171,11,2010,2010,160,128,3,7,4,7,1,3,1,2,1,2
Yemen,162,25,2010,2010,137,129,13,5,17,8,5,1,7,2,1,2
Liberia,158,2,2010,2010,156,130,1,1,1,1,0,0,0,1,1,0
Madagascar,154,1,2010,2010,153,131,3,1,1,0,1,0,1,1,1,0
Sierra Leone,151,1,2010,2010,150,132,1,1,0,1,0,0,0,0,1,1
Namibia,146,1,2010,2010,145,133,1,2,0,1,0,0,0,1,1,1
Guyana,145,9,2010,2010,136,134,4,6,3,6,1,2,1,3,2,1
Rwanda,138,1,2010,2010,137,135,2,4,0,1,0,0,2,3,0,1
Luxembourg,135,2,2010,2010,133,136,4,3,1,1,0,0,1,3,3,0
Turkmenistan,135,3,2010,2010,132,137,1,1,1,2,1,1,0,0,0,0
St. Lucia,132,5,2010,2010,127,138,4,3,4,1,0,0,2,3,2,0
Swaziland,126,2,2010,2010,124,139,1,3,0,2,0,0,1,3,0,0
Kazakhstan,121,3,2010,2010,118,140,5,1,3,0,1,0,4,1,0,0
Dominica,118,16,2010,2010,102,141,1,5,0,16,0,3,1,1,0,1
Moldova,117,9,2010,2010,108,142,4,4,4,5,1,2,2,1,1,1
Niger,116,5,2010,2010,111,143,3,3,4,1,2,0,0,1,1,2
Tajikistan,115,10,2010,2010,105,144,5,3,6,4,3,2,2,1,0,0
Botswana,111,12,2010,2010,99,145,5,5,8,4,5,2,0,1,0,2
Bangladesh,108,3,2010,2010,105,146,1,2,1,2,0,1,1,1,0,0
Faroe Islands,103,3,2010,2010,100,147,2,6,1,2,0,0,1,5,1,1
Armenia,100,14,2010,2010,86,148,6,1,12,2,3,0,3,0,0,1
Palestine,96,2,2010,2010,94,149,1,3,0,2,0,0,1,1,0,2
Azerbaijan,95,9,2010,2010,86,150,5,5,4,5,1,2,1,3,3,0
Burundi,94,3,2010,2010,91,151,2,2,2,1,1,0,1,0,0,2
Guinea-Bissau,87,2,2010,2010,85,152,1,2,1,1,1,0,0,2,0,0
Cape Verde,86,3,2010,2010,83,153,2,3,3,0,2,0,0,1,0,2
Aruba,72,3,2010,2010,69,154,2,1,3,0,0,0,1,1,1,0
Cayman Islands,63,5,2010,2010,58,155,1,2,4,1,1,0,0,1,0,1
Chad,63,6,2010,2010,57,156,2,5,3,3,0,0,1,3,1,2
Philippines,56,10,2010,2010,46,157,2,6,5,5,1,1,0,2,1,3
Liechtenstein,53,3,2010,2010,50,158,2,3,0,3,0,0,2,1,0,2
Laos,52,5,2010,2010,47,159,2,4,2,3,0,0,0,3,2,1
British Virgin Islands,47,3,2010,2010,44,160,1,3,0,3,0,1,1,2,0,0
Puerto Rico,45,10,2010,2010,35,161,4,2,7,3,3,0,1,2,0,0
Central African Republic,39,2,2010,2010,37,162,1,1,2,0,1,0,0,0,0,1
Equatorial Guinea,37,3,2010,2010,34,163,1,1,2,1,1,0,0,1,0,0
Montenegro,37,9,2010,2010,28,164,5,4,6,3,4,1,1,2,0,1
St. Martin,31,8,2010,2010,23,165,2,3,4,4,1,1,0,2,1,0
Andorra,28,1,2010,2010,27,166,2,5,0,1,0,0,2,5,0,0
Anguilla,26,6,2010,2010,20,167,3,2,4,2,1,0,2,2,0,0
Belize,24,2,2010,2010,22,168,1,1,0,2,0,0,0,1,1,0
Réunion,24,2,2010,2010,22,169,1,1,0,2,0,1,0,0,1,0
San Marino,14,0,2010,2010,14,170,2,3,0,0,0,0,2,3,0,0
Montserrat,10,0,2010,2010,10,171,1,1,0,0,0,0,1,1,0,0
Mayotte,6,1,2010,2010,5,172,2,1,1,0,0,0,2,0,0,1
Comoros,4,0,2010,2010,4,173,1,1,0,0,0,0,1,1,0,0
Germany,2304,36,2011,2010.1,2268,1,8,5,23,13,6,3,1,0,1,2
Sweden,1821,28,2011,2010.1,1793,2,4,9,11,17,3,6,0,3,1,0
Hungary,1701,23,2011,2010.1,1678,3,5,6,11,12,3,4,1,2,1,0
Brazil,1682,21,2011,2010.1,1661,4,10,6,14,7,6,3,0,2,4,1
England,1588,15,2011,2010.1,1573,5,5,4,6,9,3,3,0,0,2,1
Argentina,1542,35,2011,2010.1,1507,6,14,7,30,5,8,1,0,4,6,2
Netherlands,1351,29,2011,2010.1,1322,7,5,6,20,9,4,2,0,2,1,2
South Korea,1261,35,2011,2010.1,1226,8,8,9,24,11,7,3,0,2,1,4
Denmark,1254,19,2011,2010.1,1235,9,5,5,9,10,4,3,1,1,0,1
Austria,1218,13,2011,2010.1,1205,10,5,6,5,8,1,1,3,4,1,1
France,1207,16,2011,2010.1,1191,11,6,6,6,10,3,4,0,0,3,2
Czech Republic,1195,18,2011,2010.1,1177,12,4,8,8,10,3,2,1,3,0,3
Mexico,1171,39,2011,2010.1,1132,13,11,11,23,16,7,5,2,3,2,3
Scotland,1150,15,2011,2010.1,1135,14,4,6,8,7,3,3,0,3,1,0
Poland,1135,14,2011,2010.1,1121,15,7,6,8,6,3,3,2,1,2,2
Italy,1133,17,2011,2010.1,1116,16,6,6,9,8,4,4,2,0,0,2
Uruguay,1106,27,2011,2010.1,1079,17,7,8,15,12,4,4,0,2,3,2
Belgium,1085,17,2011,2010.1,1068,18,6,5,13,4,4,1,0,1,2,3
Spain,1074,30,2011,2010.1,1044,19,5,7,15,15,5,4,0,2,0,1
Norway,1068,10,2011,2010.1,1058,20,6,3,9,1,4,0,1,3,1,0
Russia,975,14,2011,2010.1,961,21,6,5,11,3,4,1,0,1,2,3
Switzerland,965,10,2011,2010.1,955,22,2,7,5,5,2,2,0,1,0,4
Romania,886,16,2011,2010.1,870,23,4,8,7,9,1,3,0,3,3,2
Zambia,870,16,2011,2010.1,854,24,2,7,3,13,1,4,0,3,1,0
China,846,37,2011,2010.1,809,25,9,8,19,18,6,4,1,3,2,1
Trinidad and Tobago,834,14,2011,2010.1,820,26,4,3,10,4,4,1,0,2,0,0
Paraguay,824,23,2011,2010.1,801,27,8,12,8,15,2,4,0,6,6,2
Chile,819,22,2011,2010.1,797,28,6,10,13,9,5,1,1,4,0,5
Bulgaria,808,3,2011,2010.1,805,29,3,5,0,3,0,1,2,3,1,1
Saudi Arabia,784,14,2011,2010.1,770,30,7,7,8,6,2,1,3,2,2,4
Ghana,772,15,2011,2010.1,757,31,4,5,8,7,3,2,0,2,1,1
Portugal,771,20,2011,2010.1,751,32,5,3,14,6,4,1,0,2,1,0
Costa Rica,769,25,2011,2010.1,744,33,9,13,12,13,1,4,2,6,6,3
Egypt,769,21,2011,2010.1,748,34,7,3,20,1,6,0,0,3,1,0
Japan,750,31,2011,2010.1,719,35,7,6,15,16,3,5,0,0,4,1
Finland,748,10,2011,2010.1,738,36,3,7,5,5,1,2,2,3,0,2
Thailand,723,9,2011,2010.1,714,37,8,3,6,3,3,0,1,2,4,1
Ivory Coast,719,21,2011,2010.1,698,38,2,5,4,17,2,4,0,0,0,1
Indonesia,712,12,2011,2010.1,700,39,6,4,11,1,2,0,3,3,1,1
Wales,711,13,2011,2010.1,698,40,7,3,12,1,4,1,3,2,0,0
USA,695,16,2011,2010.1,679,41,14,3,13,3,5,1,6,2,3,0
Iraq,688,17,2011,2010.1,671,42,8,9,8,9,3,5,5,2,0,2
Kuwait,676,26,2011,2010.1,650,43,9,10,9,17,4,4,3,3,2,3
Malaysia,665,14,2011,2010.1,651,44,4,5,7,7,3,0,0,3,1,2
Nigeria,650,22,2011,2010.1,628,45,7,4,17,5,5,1,0,1,2,2
Ireland,649,26,2011,2010.1,623,46,9,5,16,10,5,4,1,0,3,1
Iran,641,35,2011,2010.1,606,47,8,6,23,12,7,4,1,0,0,2
Tunisia,641,18,2011,2010.1,623,48,4,4,14,4,4,0,0,2,0,2
Uganda,633,20,2011,2010.1,613,49,5,11,7,13,3,5,0,4,2,2
Australia,627,34,2011,2010.1,593,50,9,8,16,18,6,6,1,1,2,1
Honduras,617,25,2011,2010.1,592,51,12,7,14,11,6,1,4,3,2,3
Kenya,616,16,2011,2010.1,600,52,7,10,10,6,4,2,3,7,0,1
Cameroon,589,16,2011,2010.1,573,53,3,7,9,7,2,2,0,1,1,4
Peru,585,16,2011,2010.1,569,54,8,8,11,5,5,1,1,3,2,4
Northern Ireland,578,7,2011,2010.1,571,55,4,6,5,2,1,0,2,6,1,0
Malawi,570,9,2011,2010.1,561,56,4,8,1,8,1,2,1,1,2,5
Morocco,566,13,2011,2010.1,553,57,5,3,11,2,3,1,1,1,1,1
Turkey,566,10,2011,2010.1,556,58,7,3,9,1,4,0,2,0,1,3
Jamaica,550,13,2011,2010.1,537,59,4,6,6,7,2,2,2,4,0,0
Greece,545,14,2011,2010.1,531,60,6,5,8,6,3,3,1,0,2,2
Senegal,540,9,2011,2010.1,531,61,4,4,7,2,3,1,1,2,0,1
Singapore,535,12,2011,2010.1,523,62,6,4,10,2,3,0,3,2,0,2
Colombia,523,15,2011,2010.1,508,63,9,5,9,6,4,3,3,1,2,1
Guinea,514,11,2011,2010.1,503,64,3,5,6,5,2,0,0,2,1,3
Algeria,506,5,2011,2010.1,501,65,3,2,4,1,3,0,0,1,0,1
Democratic Republic of the Congo,506,24,2011,2010.1,482,66,8,6,14,10,5,4,3,2,0,0
Mali,506,7,2011,2010.1,499,67,2,4,1,6,1,1,1,2,0,1
United Arab Emirates,506,22,2011,2010.1,484,68,9,5,16,6,4,0,4,4,1,1
Guatemala,493,21,2011,2010.1,472,69,6,7,11,10,3,3,2,3,1,1
Qatar,489,22,2011,2010.1,467,70,12,4,17,5,4,1,4,2,4,1
Ecuador,483,26,2011,2010.1,457,71,7,11,14,12,4,2,1,4,2,5
El Salvador,475,43,2011,2010.1,432,72,9,11,26,17,7,5,1,3,1,3
Israel,464,11,2011,2010.1,453,73,5,3,6,5,2,2,3,1,0,0
Zimbabwe,447,14,2011,2010.1,433,74,5,5,11,3,5,1,0,4,0,0
Syria,440,14,2011,2010.1,426,75,2,9,1,13,0,4,2,3,0,2
Haiti,437,8,2011,2010.1,429,76,2,3,4,4,1,1,0,2,1,0
Bahrain,427,12,2011,2010.1,415,77,6,7,7,5,2,2,1,3,3,2
Myanmar,426,5,2011,2010.1,421,78,5,5,4,1,1,0,3,4,1,1
Oman,420,12,2011,2010.1,408,79,7,7,8,4,4,2,0,2,3,3
Latvia,397,9,2011,2010.1,388,80,5,4,6,3,2,1,2,3,1,0
Tanzania,386,15,2011,2010.1,371,81,12,6,9,6,3,1,7,4,2,1
India,383,36,2011,2010.1,347,82,11,9,25,11,6,2,2,5,3,2
Bolivia,380,10,2011,2010.1,370,83,6,10,2,8,0,0,5,5,1,5
Iceland,379,4,2011,2010.1,375,84,2,4,1,3,1,0,1,3,0,1
Estonia,373,12,2011,2010.1,361,85,5,6,7,5,2,2,2,3,1,1
Sudan,372,25,2011,2010.1,347,86,5,15,5,20,1,10,2,4,2,1
Congo,368,7,2011,2010.1,361,87,3,2,1,6,0,2,2,0,1,0
Hong Kong,356,9,2011,2010.1,347,88,4,2,9,0,1,0,1,2,2,0
Croatia,353,17,2011,2010.1,336,89,5,6,11,6,4,2,0,2,1,2
Ethiopia,340,15,2011,2010.1,325,90,8,4,14,1,2,0,3,2,3,2
Togo,334,7,2011,2010.1,327,91,2,5,2,5,2,0,0,3,0,2
Panama,333,40,2011,2010.1,293,92,13,8,25,15,9,5,1,2,3,1
Cuba,329,5,2011,2010.1,324,93,6,2,4,1,1,0,3,2,2,0
Curaçao,318,9,2011,2010.1,309,94,3,7,3,6,0,0,3,5,0,2
Canada,315,23,2011,2010.1,292,95,6,6,12,11,3,3,0,2,3,1
Burkina Faso,310,8,2011,2010.1,302,96,3,4,6,2,2,0,0,2,1,2
Angola,308,9,2011,2010.1,299,97,6,5,6,3,3,1,1,2,2,2
Gabon,308,7,2011,2010.1,301,98,5,2,4,3,2,1,2,1,1,0
Suriname,306,11,2011,2010.1,295,99,7,3,9,2,3,1,2,1,2,1
Uzbekistan,306,24,2011,2010.1,282,100,7,8,14,10,4,3,2,3,1,2
Jordan,305,39,2011,2010.1,266,101,14,6,31,8,7,2,2,1,5,3
South Africa,305,10,2011,2010.1,295,102,5,4,7,3,3,1,0,2,2,1
Lithuania,299,7,2011,2010.1,292,103,5,3,7,0,2,0,2,3,1,0
Serbia,295,11,2011,2010.1,284,104,3,9,6,5,2,2,0,5,1,2
Libya,290,5,2011,2010.1,285,105,1,3,3,2,1,0,0,0,0,3
Slovakia,288,7,2011,2010.1,281,106,4,5,2,5,1,2,3,1,0,2
New Caledonia,265,36,2011,2010.1,229,107,8,1,36,0,5,0,3,0,0,1
Venezuela,258,24,2011,2010.1,234,108,7,15,7,17,4,4,2,6,1,5
Cyprus,257,7,2011,2010.1,250,109,8,2,6,1,1,0,5,2,2,0
Ukraine,238,18,2011,2010.1,220,110,8,4,13,5,3,1,4,1,1,2
Mozambique,229,11,2011,2010.1,218,111,5,2,10,1,3,1,1,1,1,0
Grenada,227,8,2011,2010.1,219,112,5,6,4,4,0,1,4,4,1,1
Fiji,225,25,2011,2010.1,200,113,4,3,18,7,3,2,1,1,0,0
Vietnam,220,15,2011,2010.1,205,114,2,3,8,7,2,1,0,2,0,0
Lebanon,214,16,2011,2010.1,198,115,7,5,13,3,3,1,3,4,1,0
Slovenia,214,8,2011,2010.1,206,116,5,4,4,4,1,2,3,1,1,1
Barbados,210,10,2011,2010.1,200,117,4,6,5,5,2,1,2,5,0,0
Belarus,200,8,2011,2010.1,192,118,7,2,6,2,2,0,2,1,3,1
Antigua and Barbuda,195,12,2011,2010.1,183,119,5,3,8,4,3,1,1,1,1,1
Albania,194,8,2011,2010.1,186,120,6,4,7,1,2,0,3,3,1,1
St. Kitts and Nevis,193,7,2011,2010.1,186,121,4,4,1,6,0,2,0,1,4,1
Georgia,186,8,2011,2010.1,178,122,4,5,4,4,2,1,2,3,0,1
Malta,185,5,2011,2010.1,180,123,6,2,4,1,1,0,3,2,2,0
Mauritius,183,1,2011,2010.1,182,124,2,2,1,0,0,0,2,2,0,0
Benin,181,6,2011,2010.1,175,125,2,3,2,4,0,0,2,2,0,1
Macedonia,176,5,2011,2010.1,171,126,5,4,2,3,1,1,2,3,2,0
Solomon Islands,174,23,2011,2010.1,151,127,5,6,17,6,4,2,0,3,1,1
Liberia,163,5,2011,2010.1,158,128,5,1,5,0,2,0,1,1,2,0
Yemen,162,0,2011,2010.1,162,129,1,2,0,0,0,0,0,2,1,0
Madagascar,160,6,2011,2010.1,154,130,3,4,3,3,1,0,1,4,1,0
Guyana,159,14,2011,2010.1,145,131,6,4,11,3,5,1,1,2,0,1
Rwanda,159,21,2011,2010.1,138,132,6,5,15,6,4,3,1,1,1,1
Namibia,158,12,2011,2010.1,146,133,4,5,6,6,2,2,1,1,1,2
Sierra Leone,156,5,2011,2010.1,151,134,2,3,3,2,2,0,0,2,0,1
Vanuatu,146,23,2011,2010.1,123,135,5,6,8,15,3,3,0,2,2,1
Turkmenistan,143,8,2011,2010.1,135,136,3,1,5,3,1,0,0,1,2,0
St. Lucia,142,10,2011,2010.1,132,137,3,6,6,4,1,0,2,5,0,1
Luxembourg,140,5,2011,2010.1,135,138,6,3,4,1,2,0,4,3,0,0
Bermuda,139,8,2011,2010.1,131,139,4,2,7,1,3,0,0,2,1,0
Sri Lanka,136,7,2011,2010.1,129,140,6,3,7,0,1,0,3,2,2,1
Gambia,133,8,2011,2010.1,125,141,2,5,4,4,1,1,0,4,1,0
Cambodia,131,14,2011,2010.1,117,142,4,3,10,4,2,0,2,3,0,0
Swaziland,131,5,2011,2010.1,126,143,7,5,3,2,0,1,5,3,2,1
Kazakhstan,129,8,2011,2010.1,121,144,3,5,3,5,1,0,0,4,2,1
Tajikistan,129,14,2011,2010.1,115,145,4,7,4,10,2,3,2,2,0,2
Moldova,128,11,2011,2010.1,117,146,4,6,5,6,1,1,3,5,0,0
Papua New Guinea,128,21,2011,2010.1,107,147,2,1,4,17,1,1,1,0,0,0
Niger,125,9,2011,2010.1,116,148,4,5,9,0,2,0,0,4,2,1
Lesotho,124,3,2011,2010.1,121,149,4,2,1,2,1,0,2,0,1,2
Maldives,123,17,2011,2010.1,106,150,10,2,16,1,5,0,1,2,4,0
Botswana,119,8,2011,2010.1,111,151,4,7,3,5,1,2,1,1,2,4
Dominica,118,0,2011,2010.1,118,152,2,2,0,0,0,0,2,2,0,0
Bangladesh,116,8,2011,2010.1,108,153,5,5,5,3,2,1,2,3,1,1
Armenia,114,14,2011,2010.1,100,154,3,5,5,9,1,2,1,3,1,0
Burundi,109,15,2011,2010.1,94,155,6,6,11,4,3,0,1,5,2,1
Palestine,108,12,2011,2010.1,96,156,3,8,5,7,1,3,0,4,2,1
Pakistan,107,2,2011,2010.1,105,157,3,4,2,0,0,0,1,2,2,2
Faroe Islands,106,3,2011,2010.1,103,158,3,3,2,1,1,0,2,3,0,0
Azerbaijan,104,9,2011,2010.1,95,159,6,4,6,3,1,1,4,3,1,0
Nepal,98,8,2011,2010.1,90,160,5,6,5,3,3,1,0,3,2,2
Guinea-Bissau,96,9,2011,2010.1,87,161,4,4,4,5,1,1,2,3,1,0
Cape Verde,89,3,2011,2010.1,86,162,2,1,3,0,2,0,0,1,0,0
Aruba,80,8,2011,2010.1,72,163,1,3,4,4,1,0,0,1,0,2
Philippines,78,22,2011,2010.1,56,164,6,7,13,9,4,1,1,3,1,3
Kyrgyzstan,73,5,2011,2010.1,68,165,1,4,0,5,0,1,1,3,0,0
Dominican Republic,68,20,2011,2010.1,48,166,7,3,14,6,5,1,1,1,1,1
Chad,67,4,2011,2010.1,63,167,3,2,3,1,0,1,2,1,1,0
Cayman Islands,65,2,2011,2010.1,63,168,3,3,2,0,0,0,2,3,1,0
Laos,64,12,2011,2010.1,52,169,3,2,8,4,1,0,1,2,1,0
Jersey,60,7,2011,2010.1,53,170,1,1,5,2,1,1,0,0,0,0
Liechtenstein,57,4,2011,2010.1,53,171,3,5,3,1,1,1,2,3,0,1
Nicaragua,55,9,2011,2010.1,46,172,4,6,4,5,1,1,2,4,1,1
Macau,53,6,2011,2010.1,47,173,2,4,4,2,1,0,1,4,0,0
Puerto Rico,53,8,2011,2010.1,45,174,4,2,8,0,2,0,1,0,1,2
Equatorial Guinea,46,9,2011,2010.1,37,175,5,3,8,1,3,0,1,3,1,0
Montenegro,44,7,2011,2010.1,37,176,4,4,4,3,1,0,1,4,2,0
Guam,43,4,2011,2010.1,39,177,2,3,2,2,0,1,1,2,1,0
Central African Republic,42,3,2011,2010.1,39,178,2,4,2,1,1,0,0,4,1,0
Belize,41,17,2011,2010.1,24,179,4,5,7,10,1,2,3,2,0,1
Seychelles,41,1,2011,2010.1,40,180,1,3,0,1,0,0,1,3,0,0
Somalia,38,1,2011,2010.1,37,181,2,2,0,1,0,0,1,2,1,0
Afghanistan,37,20,2011,2010.1,17,182,3,8,3,17,2,4,1,2,0,2
Eritrea,37,2,2011,2010.1,35,183,2,1,1,1,0,0,1,1,1,0
Tonga,37,4,2011,2010.1,33,184,1,2,2,2,1,0,0,1,0,1
Mongolia,30,3,2011,2010.1,27,185,2,2,3,0,2,0,0,2,0,0
Andorra,29,1,2011,2010.1,28,186,4,3,1,0,0,0,4,3,0,0
Bahamas,29,10,2011,2010.1,19,187,1,1,6,4,1,1,0,0,0,0
Samoa,29,6,2011,2010.1,23,188,3,3,5,1,2,0,0,3,1,0
Djibouti,25,2,2011,2010.1,23,189,1,4,0,2,0,0,1,4,0,0
Cook Islands,23,8,2011,2010.1,15,190,2,4,4,4,1,0,1,3,0,1
Bhutan,18,2,2011,2010.1,16,191,2,5,1,1,0,0,2,5,0,0
San Marino,14,0,2011,2010.1,14,192,5,2,0,0,0,0,5,2,0,0
Tuvalu,14,10,2011,2010.1,4,193,2,4,7,3,2,0,0,3,0,1
Montserrat,13,3,2011,2010.1,10,194,1,1,2,1,0,0,1,1,0,0
São Tomé and Príncipe,10,1,2011,2010.1,9,195,1,1,0,1,0,0,1,0,0,1
American Samoa,7,3,2011,2010.1,4,196,5,3,3,0,1,0,3,3,1,0
Comoros,7,3,2011,2010.1,4,197,3,2,2,1,0,0,2,2,1,0
Kiribati,6,1,2011,2010.1,5,198,1,2,1,0,0,0,1,2,0,0
Turks and Caicos Islands,6,0,2011,2010.1,6,199,1,1,0,0,0,0,1,1,0,0
Bonaire,5,5,2011,2010.1,0,200,1,1,2,3,0,1,0,0,1,0
Germany,2336,32,2012,2010.2,2304,1,8,6,17,15,4,4,3,1,1,1
Sweden,1849,28,2012,2010.2,1821,2,8,5,16,12,6,3,2,1,0,1
Brazil,1718,36,2012,2010.2,1682,3,6,6,21,15,4,4,1,2,1,0
Hungary,1715,14,2012,2010.2,1701,4,6,3,6,8,1,3,2,0,3,0
England,1613,25,2012,2010.2,1588,5,6,7,11,14,3,4,1,1,2,2
Argentina,1568,26,2012,2010.2,1542,6,4,7,12,14,4,4,0,1,0,2
Netherlands,1380,29,2012,2010.2,1351,7,8,5,15,14,4,3,3,2,1,0
South Korea,1280,19,2012,2010.2,1261,8,5,4,12,7,4,1,1,2,0,1
Denmark,1265,11,2012,2010.2,1254,9,7,4,7,4,1,1,5,1,1,2
Austria,1231,13,2012,2010.2,1218,10,7,1,13,0,4,0,2,0,1,1
France,1228,21,2012,2010.2,1207,11,7,7,13,8,4,4,1,2,2,1
Czech Republic,1209,14,2012,2010.2,1195,12,7,6,9,5,3,2,3,1,1,3
Mexico,1193,22,2012,2010.2,1171,13,8,3,13,9,6,3,2,0,0,0
Scotland,1159,9,2012,2010.2,1150,14,3,5,4,5,1,1,0,3,2,1
Poland,1154,19,2012,2010.2,1135,15,10,4,12,7,4,2,2,1,4,1
Italy,1151,18,2012,2010.2,1133,16,7,7,9,9,3,2,3,2,1,3
Uruguay,1118,12,2012,2010.2,1106,17,3,7,6,6,1,1,0,3,2,3
Spain,1116,42,2012,2010.2,1074,18,10,6,29,13,8,5,0,0,2,1
Belgium,1101,16,2012,2010.2,1085,19,4,5,9,7,2,2,0,2,2,1
Norway,1083,15,2012,2010.2,1068,20,4,6,5,10,1,4,2,1,1,1
Russia,997,22,2012,2010.2,975,21,7,6,12,10,4,3,0,1,3,2
Switzerland,984,19,2012,2010.2,965,22,5,4,9,10,2,4,2,0,1,0
Romania,905,19,2012,2010.2,886,23,5,5,12,7,3,3,1,1,1,1
Zambia,888,18,2012,2010.2,870,24,7,10,8,10,5,4,0,4,2,2
China,856,10,2012,2010.2,846,25,5,3,10,0,3,0,0,3,2,0
Trinidad and Tobago,856,22,2012,2010.2,834,26,4,6,17,5,3,1,1,3,0,2
Paraguay,839,15,2012,2010.2,824,27,6,5,9,6,5,1,1,3,0,1
Chile,834,15,2012,2010.2,819,28,4,7,6,9,1,3,2,4,1,0
Bulgaria,816,8,2012,2010.2,808,29,6,3,5,3,2,1,2,0,2,2
Egypt,810,41,2012,2010.2,769,30,14,6,30,11,10,3,2,0,2,3
Saudi Arabia,800,16,2012,2010.2,784,31,7,6,13,3,3,1,2,4,2,1
Ghana,790,18,2012,2010.2,772,32,7,6,15,3,5,1,1,3,1,2
Costa Rica,789,20,2012,2010.2,769,33,6,7,13,7,2,3,2,2,2,2
Portugal,788,17,2012,2010.2,771,34,7,7,9,8,3,3,1,2,3,2
Japan,771,21,2012,2010.2,750,35,9,3,17,4,6,2,2,0,1,1
Finland,766,18,2012,2010.2,748,36,4,6,5,13,1,4,1,1,2,1
Thailand,754,31,2012,2010.2,723,37,11,3,29,2,10,0,1,2,0,1
Ivory Coast,745,26,2012,2010.2,719,38,7,8,12,14,6,5,0,0,1,3
USA,718,23,2012,2010.2,695,39,6,8,14,9,5,4,1,1,0,3
Indonesia,717,5,2012,2010.2,712,40,3,4,3,2,1,0,0,2,2,2
Wales,714,3,2012,2010.2,711,41,3,3,2,1,1,0,2,3,0,0
Iraq,710,22,2012,2010.2,688,42,11,9,16,6,5,2,3,4,3,3
Kuwait,689,13,2012,2010.2,676,43,8,7,11,2,5,1,1,5,2,1
Malaysia,688,23,2012,2010.2,665,44,10,6,17,6,4,1,2,3,4,2
Tunisia,668,27,2012,2010.2,641,45,6,9,13,14,3,5,2,2,1,2
Nigeria,663,13,2012,2010.2,650,46,3,8,3,10,2,2,0,2,1,4
Iran,662,21,2012,2010.2,641,47,12,4,20,1,5,1,1,2,6,1
Ireland,662,13,2012,2010.2,649,48,5,6,7,6,1,2,3,2,1,2
Australia,659,32,2012,2010.2,627,49,3,9,13,19,2,5,0,3,1,1
Uganda,657,24,2012,2010.2,633,50,9,6,19,5,8,0,0,3,1,3
Honduras,633,16,2012,2010.2,617,51,5,6,9,7,2,2,2,1,1,3
Kenya,629,13,2012,2010.2,616,52,6,8,10,3,4,1,1,7,1,0
Cameroon,609,20,2012,2010.2,589,53,3,12,5,15,3,4,0,4,0,4
Peru,595,10,2012,2010.2,585,54,5,7,4,6,2,1,2,3,1,3
Morocco,587,21,2012,2010.2,566,55,8,8,12,9,3,2,4,3,1,3
Northern Ireland,584,6,2012,2010.2,578,56,4,3,5,1,0,0,1,2,3,1
Turkey,584,18,2012,2010.2,566,57,5,7,7,11,2,3,2,4,1,0
Malawi,580,10,2012,2010.2,570,58,4,8,7,3,3,0,0,6,1,2
Jamaica,570,20,2012,2010.2,550,59,10,6,13,7,6,2,2,3,2,1
Greece,562,17,2012,2010.2,545,60,5,7,6,11,2,5,1,1,2,1
Singapore,560,25,2012,2010.2,535,61,9,9,20,5,6,1,1,6,2,2
Senegal,552,12,2012,2010.2,540,62,4,7,5,7,2,1,2,3,0,3
Colombia,539,16,2012,2010.2,523,63,3,5,9,7,3,3,0,1,0,1
United Arab Emirates,532,26,2012,2010.2,506,64,9,1,26,0,8,0,0,1,1,0
Guinea,529,15,2012,2010.2,514,65,4,8,4,11,1,3,2,2,1,3
Democratic Republic of the Congo,522,16,2012,2010.2,506,66,4,6,9,7,3,1,1,2,0,3
Algeria,521,15,2012,2010.2,506,67,3,3,11,4,3,2,0,1,0,0
Mali,517,11,2012,2010.2,506,68,4,5,6,5,3,2,1,2,0,1
Guatemala,512,19,2012,2010.2,493,69,6,8,10,9,3,2,1,6,2,0
Qatar,496,7,2012,2010.2,489,70,6,4,3,4,1,1,4,1,1,2
Ecuador,494,11,2012,2010.2,483,71,5,3,10,1,5,0,0,1,0,2
El Salvador,488,13,2012,2010.2,475,72,9,3,8,5,2,1,5,1,2,1
Israel,479,15,2012,2010.2,464,73,4,5,6,9,1,1,3,2,0,2
Zimbabwe,458,11,2012,2010.2,447,74,4,5,9,2,3,0,1,3,0,2
Haiti,454,17,2012,2010.2,437,75,7,2,14,3,5,2,1,0,1,0
Syria,454,14,2012,2010.2,440,76,3,8,6,8,2,1,0,3,1,4
Bahrain,453,26,2012,2010.2,427,77,12,8,20,6,5,1,3,5,4,2
Oman,446,26,2012,2010.2,420,78,16,4,22,4,7,1,5,2,4,1
New Zealand,434,22,2012,2010.2,412,79,3,8,8,14,1,5,2,0,0,3
Myanmar,432,6,2012,2010.2,426,80,4,3,5,1,2,0,0,2,2,1
Latvia,407,10,2012,2010.2,397,81,5,3,8,2,2,0,2,2,1,1
Tanzania,405,19,2012,2010.2,386,82,8,5,7,12,4,2,1,2,3,1
Iceland,393,14,2012,2010.2,379,83,3,7,4,10,2,2,1,5,0,0
Bolivia,392,12,2012,2010.2,380,84,7,1,12,0,4,0,1,1,2,0
India,391,8,2012,2010.2,383,85,7,3,7,1,2,0,3,3,2,0
Martinique,387,42,2012,2010.2,345,86,10,6,35,7,6,1,1,1,3,4
Sudan,385,13,2012,2010.2,372,87,6,10,10,3,2,2,2,6,2,2
Estonia,383,10,2012,2010.2,373,88,5,8,3,7,2,3,3,5,0,0
Congo,378,10,2012,2010.2,368,89,2,5,4,6,2,1,0,3,0,1
Croatia,370,17,2012,2010.2,353,90,6,5,9,8,3,2,3,0,0,3
Hong Kong,368,12,2012,2010.2,356,91,7,2,11,1,4,0,3,1,0,1
Ethiopia,350,10,2012,2010.2,340,92,4,6,4,6,3,0,0,4,1,2
Panama,345,12,2012,2010.2,333,93,7,6,8,4,4,2,2,3,1,1
Togo,341,7,2012,2010.2,334,94,3,8,2,5,1,2,1,5,1,1
Cuba,338,9,2012,2010.2,329,95,5,9,7,2,2,2,2,7,1,0
Curaçao,331,13,2012,2010.2,318,96,1,3,1,12,0,1,1,2,0,0
Suriname,327,21,2012,2010.2,306,97,1,6,8,13,1,2,0,3,0,1
Canada,324,9,2012,2010.2,315,98,5,4,6,3,3,1,0,3,2,0
Angola,322,14,2012,2010.2,308,99,8,6,9,5,3,1,0,2,5,3
Burkina Faso,321,11,2012,2010.2,310,100,5,9,8,3,2,2,2,5,1,2
Jordan,321,16,2012,2010.2,305,101,6,9,9,7,3,1,1,7,2,1
Gabon,320,12,2012,2010.2,308,102,10,2,12,0,5,0,0,2,5,0
Uzbekistan,320,14,2012,2010.2,306,103,3,10,5,9,1,4,1,4,1,2
South Africa,317,12,2012,2010.2,305,104,6,5,9,3,3,1,1,2,2,2
Libya,311,21,2012,2010.2,290,105,10,5,17,4,6,2,1,2,3,1
Serbia,307,12,2012,2010.2,295,106,4,7,9,3,2,1,1,4,1,2
Lithuania,305,6,2012,2010.2,299,107,2,7,1,5,0,1,0,5,2,1
Slovakia,298,10,2012,2010.2,288,108,3,6,4,6,2,2,1,3,0,1
New Caledonia,292,27,2012,2010.2,265,109,4,4,14,13,2,3,2,1,0,0
Venezuela,269,11,2012,2010.2,258,110,4,7,5,6,1,1,2,4,1,2
Guadeloupe,262,12,2012,2010.2,250,111,6,2,9,3,2,1,3,1,1,0
Cyprus,261,4,2012,2010.2,257,112,4,3,2,2,1,0,2,3,1,0
Ukraine,251,13,2012,2010.2,238,113,6,6,6,7,2,2,3,2,1,2
Mozambique,238,9,2012,2010.2,229,114,4,6,6,3,2,1,0,4,2,1
Vietnam,231,11,2012,2010.2,220,115,6,4,6,5,2,2,2,2,2,0
Fiji,226,1,2012,2010.2,225,116,1,2,0,1,0,0,1,0,0,2
Lebanon,226,12,2012,2010.2,214,117,10,7,7,5,3,1,6,5,1,1
Slovenia,225,11,2012,2010.2,214,118,4,4,7,4,2,0,1,3,1,1
Belarus,208,8,2012,2010.2,200,119,3,5,3,5,1,2,1,2,1,1
Albania,203,9,2012,2010.2,194,120,7,2,8,1,4,0,1,2,2,0
Antigua and Barbuda,202,7,2012,2010.2,195,121,7,4,4,3,1,0,5,4,1,0
Malta,194,9,2012,2010.2,185,122,2,5,2,7,1,3,1,2,0,0
Georgia,193,7,2012,2010.2,186,123,5,3,4,3,2,1,2,1,1,1
Benin,186,5,2012,2010.2,181,124,2,4,2,3,1,0,0,1,1,3
Macedonia,185,9,2012,2010.2,176,125,5,5,7,2,3,0,2,2,0,3
Mauritius,185,2,2012,2010.2,183,126,1,1,2,0,1,0,0,0,0,1
Solomon Islands,182,8,2012,2010.2,174,127,5,2,7,1,1,0,2,2,2,0
Guyana,172,13,2012,2010.2,159,128,4,11,2,11,0,3,4,6,0,2
Liberia,171,8,2012,2010.2,163,129,7,4,6,2,3,0,2,3,2,1
Yemen,170,8,2012,2010.2,162,130,3,8,1,7,0,1,3,7,0,0
Sierra Leone,169,13,2012,2010.2,156,131,4,6,9,4,2,0,0,4,2,2
Rwanda,168,9,2012,2010.2,159,132,5,8,5,4,1,1,1,5,3,2
Madagascar,161,1,2012,2010.2,160,133,1,1,0,1,0,0,1,1,0,0
Namibia,161,3,2012,2010.2,158,134,3,5,1,2,1,0,0,2,2,3
Turkmenistan,156,13,2012,2010.2,143,135,2,5,5,8,2,3,0,1,0,1
Bermuda,149,10,2012,2010.2,139,136,1,2,1,9,0,1,1,1,0,0
Luxembourg,146,6,2012,2010.2,140,137,6,2,5,1,1,0,5,1,0,1
Gambia,138,5,2012,2010.2,133,138,2,3,2,3,0,0,1,2,1,1
Kazakhstan,135,6,2012,2010.2,129,139,3,4,6,0,1,0,1,3,1,1
Tajikistan,135,6,2012,2010.2,129,140,1,3,1,5,0,2,1,1,0,0
Cambodia,133,2,2012,2010.2,131,141,2,2,2,0,0,0,1,2,1,0
Swaziland,133,2,2012,2010.2,131,142,1,2,0,2,0,1,0,1,1,0
Botswana,131,12,2012,2010.2,119,143,9,5,10,2,2,0,2,4,5,1
Maldives,130,7,2012,2010.2,123,144,3,5,4,3,2,1,1,4,0,0
Moldova,130,2,2012,2010.2,128,145,3,5,0,2,0,1,1,3,2,1
Niger,130,5,2012,2010.2,125,146,5,6,5,0,1,0,2,6,2,0
Papua New Guinea,130,2,2012,2010.2,128,147,2,1,2,0,0,0,1,1,1,0
Lesotho,129,5,2012,2010.2,124,148,4,6,2,3,1,0,1,4,2,2
Armenia,127,13,2012,2010.2,114,149,7,2,12,1,3,1,4,1,0,0
Palestine,127,19,2012,2010.2,108,150,5,11,5,14,2,4,1,5,2,2
Dominica,122,4,2012,2010.2,118,151,1,2,3,1,1,0,0,2,0,0
Burundi,119,10,2012,2010.2,109,152,3,3,8,2,3,2,0,1,0,0
Azerbaijan,114,10,2012,2010.2,104,153,3,7,4,6,1,1,0,4,2,2
Philippines,111,33,2012,2010.2,78,154,11,11,24,9,8,3,0,5,3,3
Faroe Islands,108,2,2012,2010.2,106,155,2,2,2,0,0,0,2,2,0,0
Cape Verde,100,11,2012,2010.2,89,156,4,2,6,5,2,1,2,1,0,0
Nepal,100,2,2012,2010.2,98,157,5,3,1,1,0,0,4,2,1,1
Guinea-Bissau,96,0,2012,2010.2,96,158,1,1,0,0,0,0,1,1,0,0
Aruba,89,9,2012,2010.2,80,159,3,2,6,3,2,0,0,2,1,0
Dominican Republic,83,15,2012,2010.2,68,160,3,6,4,11,1,4,1,1,1,1
Laos,79,15,2012,2010.2,64,161,3,7,5,10,2,1,1,4,0,2
Puerto Rico,74,21,2012,2010.2,53,162,5,6,15,6,2,1,2,5,1,0
Chad,71,4,2012,2010.2,67,163,3,2,4,0,1,0,1,2,1,0
Mauritania,66,3,2012,2010.2,63,164,1,3,2,1,1,1,0,2,0,0
Montenegro,62,18,2012,2010.2,44,165,4,3,9,9,3,2,0,0,1,1
Nicaragua,62,7,2012,2010.2,55,166,2,2,5,2,2,0,0,1,0,1
Guam,61,18,2012,2010.2,43,167,4,4,14,4,3,1,1,3,0,0
Liechtenstein,59,2,2012,2010.2,57,168,3,3,1,1,1,0,2,3,0,0
Macau,58,5,2012,2010.2,53,169,1,3,0,5,0,1,1,2,0,0
Equatorial Guinea,55,9,2012,2010.2,46,170,8,2,8,1,4,0,2,2,2,0
Central African Republic,49,7,2012,2010.2,42,171,3,2,4,3,2,1,0,1,1,0
British Virgin Islands,48,1,2012,2010.2,47,172,3,1,1,0,1,0,2,1,0,0
Seychelles,42,1,2012,2010.2,41,173,2,2,1,0,0,0,2,2,0,0
Eritrea,39,2,2012,2010.2,37,174,1,1,0,2,0,0,1,1,0,0
Somalia,39,1,2012,2010.2,38,175,2,1,0,1,0,0,2,1,0,0
St. Martin,31,0,2012,2010.2,31,176,1,2,0,0,0,0,1,2,0,0
Andorra,29,0,2012,2010.2,29,177,3,5,0,0,0,0,3,4,0,1
Montserrat,21,8,2012,2010.2,13,178,1,2,1,7,0,1,1,1,0,0
Brunei,20,4,2012,2010.2,16,179,1,2,1,3,0,1,1,1,0,0
San Marino,16,2,2012,2010.2,14,180,3,2,2,0,0,0,3,2,0,0
São Tomé and Príncipe,15,5,2012,2010.2,10,181,2,2,3,2,2,0,0,1,0,1
Bonaire,7,2,2012,2010.2,5,182,1,1,2,0,0,0,1,1,0,0
Comoros,7,0,2012,2010.2,7,183,1,1,0,0,0,0,0,1,1,0
Northern Mariana Islands,7,2,2012,2010.2,5,184,1,2,1,1,0,0,1,2,0,0
South Sudan,2,2,2012,2010.2,0,185,2,2,2,0,0,0,1,2,1,0
Germany,2371,35,2013,2010.3,2336,1,4,8,13,22,3,6,0,1,1,1
Sweden,1872,23,2013,2010.3,1849,2,9,5,19,4,5,2,3,2,1,1
Brazil,1767,49,2013,2010.3,1718,3,12,7,34,15,10,3,0,2,2,2
Hungary,1729,14,2013,2010.3,1715,4,6,3,12,2,3,0,0,2,3,1
England,1640,27,2013,2010.3,1613,5,8,4,16,11,5,1,2,0,1,3
Argentina,1592,24,2013,2010.3,1568,6,4,7,6,18,2,4,0,1,2,2
Netherlands,1410,30,2013,2010.3,1380,7,6,6,18,12,3,4,0,0,3,2
South Korea,1296,16,2013,2010.3,1280,8,12,3,14,2,5,0,4,2,3,1
Denmark,1286,21,2013,2010.3,1265,9,6,5,13,8,3,3,1,2,2,0
Austria,1248,17,2013,2010.3,1231,10,5,5,10,7,4,1,1,3,0,1
France,1248,20,2013,2010.3,1228,11,6,6,16,4,4,1,2,3,0,2
Czech Republic,1224,15,2013,2010.3,1209,12,4,6,3,12,1,4,2,1,1,1
Mexico,1221,28,2013,2010.3,1193,13,12,10,14,14,4,4,3,4,5,2
Italy,1183,32,2013,2010.3,1151,14,10,8,21,11,4,2,1,1,5,5
Poland,1176,22,2013,2010.3,1154,15,7,6,12,10,3,2,2,3,2,1
Scotland,1169,10,2013,2010.3,1159,16,5,5,4,6,2,3,2,2,1,0
Uruguay,1144,26,2013,2010.3,1118,17,6,10,9,17,3,5,0,5,3,0
Spain,1142,26,2013,2010.3,1116,18,8,8,14,12,5,6,0,2,3,0
Belgium,1119,18,2013,2010.3,1101,19,7,4,8,10,3,4,2,0,2,0
Norway,1093,10,2013,2010.3,1083,20,7,6,5,5,2,1,4,3,1,2
Russia,1015,18,2013,2010.3,997,21,5,5,11,7,3,2,0,2,2,1
Switzerland,996,12,2013,2010.3,984,22,4,5,7,5,3,2,0,1,1,2
Romania,927,22,2013,2010.3,905,23,8,4,15,7,4,1,2,2,2,1
Zambia,917,29,2013,2010.3,888,24,16,11,21,8,6,1,3,4,7,6
China,877,21,2013,2010.3,856,25,8,6,12,9,4,1,3,2,1,3
Trinidad and Tobago,869,13,2013,2010.3,856,26,3,10,2,11,1,3,1,4,1,3
Chile,867,33,2013,2010.3,834,27,7,7,21,12,7,2,0,2,0,3
Paraguay,853,14,2013,2010.3,839,28,4,4,8,6,1,0,3,1,0,3
Egypt,846,36,2013,2010.3,810,29,8,7,26,10,7,2,0,5,1,0
Ghana,831,41,2013,2010.3,790,30,10,9,27,14,8,3,0,4,2,2
Bulgaria,830,14,2013,2010.3,816,31,2,7,6,8,1,3,1,3,0,1
Costa Rica,817,28,2013,2010.3,789,32,12,10,20,8,11,2,0,5,1,3
Saudi Arabia,816,16,2013,2010.3,800,33,5,8,5,11,2,4,3,2,0,2
Portugal,811,23,2013,2010.3,788,34,6,6,9,14,3,4,1,1,2,1
Japan,804,33,2013,2010.3,771,35,10,9,21,12,5,3,3,5,2,1
Finland,780,14,2013,2010.3,766,36,3,9,3,11,2,3,1,3,0,3
Ivory Coast,778,33,2013,2010.3,745,37,8,8,19,14,6,2,1,3,1,3
Thailand,766,12,2013,2010.3,754,38,4,5,3,9,1,1,3,4,0,0
USA,759,41,2013,2010.3,718,39,14,7,34,7,12,2,1,3,1,2
Iraq,727,17,2013,2010.3,710,40,9,11,9,8,5,2,3,6,1,3
Indonesia,725,8,2013,2010.3,717,41,6,3,8,0,2,0,3,3,1,0
Wales,723,9,2013,2010.3,714,42,6,3,5,4,2,1,2,1,2,1
Kuwait,716,27,2013,2010.3,689,43,8,8,14,13,6,3,0,3,2,2
Nigeria,698,35,2013,2010.3,663,44,9,13,16,19,5,6,2,2,2,5
Malaysia,692,4,2013,2010.3,688,45,5,4,4,0,1,0,3,4,1,0
Tunisia,686,18,2013,2010.3,668,46,6,8,10,8,4,0,0,3,2,5
Iran,684,22,2013,2010.3,662,47,3,6,11,11,3,4,0,1,0,1
Ireland,681,19,2013,2010.3,662,48,7,7,18,1,5,0,1,3,1,4
Australia,678,19,2013,2010.3,659,49,6,6,14,5,4,0,1,4,1,2
Uganda,675,18,2013,2010.3,657,50,7,8,10,8,5,2,0,5,2,1
Honduras,656,23,2013,2010.3,633,51,13,9,15,8,6,2,3,5,4,2
Kenya,648,19,2013,2010.3,629,52,12,2,16,3,7,0,2,0,3,2
Cameroon,621,12,2013,2010.3,609,53,5,7,8,4,4,1,1,2,0,4
Peru,607,12,2013,2010.3,595,54,5,6,7,5,3,1,1,3,1,2
Turkey,604,20,2013,2010.3,584,55,9,3,14,6,3,3,3,0,3,0
Morocco,600,13,2013,2010.3,587,56,6,6,7,6,2,1,1,1,3,4
Northern Ireland,590,6,2013,2010.3,584,57,3,5,3,3,1,0,2,3,0,2
Malawi,586,6,2013,2010.3,580,58,3,6,3,3,0,2,0,3,3,1
Jamaica,575,5,2013,2010.3,570,59,6,6,5,0,0,0,3,4,3,2
Greece,574,12,2013,2010.3,562,60,5,4,7,5,4,3,0,0,1,1
Singapore,572,12,2013,2010.3,560,61,4,6,4,8,3,2,1,4,0,0
United Arab Emirates,568,36,2013,2010.3,532,62,9,4,25,11,8,4,0,0,1,0
Senegal,560,8,2013,2010.3,552,63,4,5,3,5,1,1,1,2,2,2
Colombia,555,16,2013,2010.3,539,64,5,6,12,4,4,2,0,2,1,2
Guinea,543,14,2013,2010.3,529,65,3,4,9,5,3,0,0,2,0,2
Algeria,539,18,2013,2010.3,521,66,8,5,12,6,5,2,1,2,2,1
Qatar,536,40,2013,2010.3,496,67,17,6,33,7,11,2,3,4,3,0
Mali,533,16,2013,2010.3,517,68,6,9,11,5,3,1,1,6,2,2
Democratic Republic of the Congo,530,8,2013,2010.3,522,69,5,6,4,4,1,1,0,2,4,3
Guatemala,515,3,2013,2010.3,512,70,4,5,2,1,0,0,2,3,2,2
Ecuador,514,20,2013,2010.3,494,71,6,7,13,7,3,1,2,3,1,3
El Salvador,495,7,2013,2010.3,488,72,4,6,4,3,2,0,0,5,2,1
Israel,492,13,2013,2010.3,479,73,4,5,7,6,1,2,0,2,3,1
Zimbabwe,475,17,2013,2010.3,458,74,7,9,9,8,3,3,1,4,3,2
Bahrain,467,14,2013,2010.3,453,75,11,6,9,5,5,1,2,2,4,3
Oman,462,16,2013,2010.3,446,76,8,9,10,6,5,2,0,3,3,4
Haiti,461,7,2013,2010.3,454,77,2,7,1,6,0,1,2,5,0,1
Syria,461,7,2013,2010.3,454,78,3,4,5,2,1,0,1,4,1,0
New Zealand,441,7,2013,2010.3,434,79,2,4,4,3,1,2,1,1,0,1
Tanzania,420,15,2013,2010.3,405,80,7,8,9,6,3,1,1,5,3,2
Latvia,417,10,2013,2010.3,407,81,2,8,4,6,1,0,0,5,1,3
Iceland,407,14,2013,2010.3,393,82,6,4,7,7,3,1,2,1,1,2
India,406,15,2013,2010.3,391,83,5,6,8,7,3,2,1,3,1,1
Bolivia,399,7,2013,2010.3,392,84,4,5,3,4,0,0,1,3,3,2
Sudan,397,12,2013,2010.3,385,85,6,7,7,5,2,2,2,4,2,1
Estonia,396,13,2013,2010.3,383,86,8,5,9,4,3,1,2,4,3,0
Martinique,389,2,2013,2010.3,387,87,1,2,1,1,0,1,1,1,0,0
Croatia,387,17,2013,2010.3,370,88,6,6,9,8,3,3,3,1,0,2
Congo,383,5,2013,2010.3,378,89,3,4,2,3,2,0,1,2,0,2
Panama,376,31,2013,2010.3,345,90,13,9,22,9,6,2,2,4,5,3
Hong Kong,370,2,2013,2010.3,368,91,5,3,2,0,2,0,3,1,0,2
Ethiopia,364,14,2013,2010.3,350,92,7,9,8,6,4,2,3,4,0,3
Togo,351,10,2013,2010.3,341,93,4,6,5,5,2,1,1,5,1,0
South Africa,346,29,2013,2010.3,317,94,13,7,17,12,6,4,3,1,4,2
Burkina Faso,345,24,2013,2010.3,321,95,7,13,14,10,5,4,0,8,2,1
Cuba,344,6,2013,2010.3,338,96,1,3,4,2,1,0,0,3,0,0
Jordan,343,22,2013,2010.3,321,97,14,4,20,2,9,0,1,1,4,3
Uzbekistan,339,19,2013,2010.3,320,98,6,6,10,9,3,3,0,2,3,1
Angola,337,15,2013,2010.3,322,99,6,7,9,6,3,2,0,3,3,2
Libya,331,20,2013,2010.3,311,100,10,8,13,7,7,2,0,4,3,2
Gabon,327,7,2013,2010.3,320,101,5,4,7,0,2,0,0,3,3,1
Canada,325,1,2013,2010.3,324,102,5,7,0,1,0,0,4,5,1,2
Serbia,325,18,2013,2010.3,307,103,4,6,10,8,3,2,0,3,1,1
Lithuania,314,9,2013,2010.3,305,104,3,5,4,5,2,0,1,3,0,2
Slovakia,306,8,2013,2010.3,298,105,2,7,1,7,0,1,0,2,2,4
Ukraine,284,33,2013,2010.3,251,106,7,5,16,17,5,4,0,1,2,0
Venezuela,279,10,2013,2010.3,269,107,6,3,9,1,3,0,1,2,2,1
Cyprus,262,1,2013,2010.3,261,108,4,3,1,0,0,0,2,3,2,0
Mozambique,246,8,2013,2010.3,238,109,4,7,3,5,1,1,1,3,2,3
Lebanon,239,13,2013,2010.3,226,110,8,10,11,2,2,0,2,5,4,5
Slovenia,239,14,2013,2010.3,225,111,4,5,6,8,3,3,1,2,0,0
Vietnam,235,4,2013,2010.3,231,112,2,4,1,3,0,1,2,3,0,0
Belarus,223,15,2013,2010.3,208,113,6,7,8,7,2,2,1,4,3,1
Albania,214,11,2013,2010.3,203,114,5,5,9,2,2,1,2,2,1,2
Malta,201,7,2013,2010.3,194,115,6,4,6,1,1,1,4,3,1,0
Georgia,197,4,2013,2010.3,193,116,2,6,0,4,0,1,1,5,1,0
Macedonia,194,9,2013,2010.3,185,117,5,5,8,1,3,0,2,5,0,0
Benin,192,6,2013,2010.3,186,118,2,2,3,3,1,0,1,1,0,1
Mauritius,190,5,2013,2010.3,185,119,2,3,4,1,1,0,1,3,0,0
Liberia,175,4,2013,2010.3,171,120,2,3,2,2,1,1,1,2,0,0
Sierra Leone,175,6,2013,2010.3,169,121,2,2,5,1,1,0,0,2,1,0
Rwanda,174,6,2013,2010.3,168,122,7,6,5,1,2,0,4,4,1,2
Yemen,174,4,2013,2010.3,170,123,3,6,1,3,0,0,3,6,0,0
Namibia,173,12,2013,2010.3,161,124,9,4,11,1,3,0,3,3,3,1
Turkmenistan,163,7,2013,2010.3,156,125,1,1,7,0,1,0,0,1,0,0
Luxembourg,155,9,2013,2010.3,146,126,6,4,6,3,2,0,3,2,1,2
Maldives,154,24,2013,2010.3,130,127,4,4,14,10,2,1,1,2,1,1
Botswana,149,18,2013,2010.3,131,128,7,7,10,8,5,1,1,4,1,2
Tajikistan,149,14,2013,2010.3,135,129,3,3,7,7,3,2,0,1,0,0
Sri Lanka,147,11,2013,2010.3,136,130,3,3,9,2,2,0,1,3,0,0
Kazakhstan,145,10,2013,2010.3,135,131,5,4,4,6,2,1,3,2,0,1
Moldova,145,15,2013,2010.3,130,132,7,3,9,6,2,1,2,2,3,0
Palestine,144,17,2013,2010.3,127,133,2,7,1,16,1,3,0,3,1,1
Lesotho,142,13,2013,2010.3,129,134,6,4,7,6,1,1,3,2,2,1
Gambia,140,2,2013,2010.3,138,135,4,2,2,0,1,0,2,2,1,0
Niger,139,9,2013,2010.3,130,136,6,5,6,3,2,0,2,4,2,1
Armenia,138,11,2013,2010.3,127,137,5,4,3,8,1,2,3,1,1,1
Cambodia,133,0,2013,2010.3,133,138,1,3,0,0,0,0,1,3,0,0
Swaziland,133,0,2013,2010.3,133,139,3,5,0,0,0,0,3,4,0,1
Philippines,127,16,2013,2010.3,111,140,4,5,13,3,3,2,1,2,0,1
Azerbaijan,125,11,2013,2010.3,114,141,6,6,8,3,3,0,1,1,2,5
Burundi,125,6,2013,2010.3,119,142,1,5,2,4,1,0,0,3,0,2
Bangladesh,124,8,2013,2010.3,116,143,3,3,6,2,1,1,1,2,1,0
Pakistan,116,9,2013,2010.3,107,144,1,11,2,7,1,3,0,6,0,2
Faroe Islands,112,4,2013,2010.3,108,145,3,6,1,3,0,0,2,6,1,0
Cape Verde,111,11,2013,2010.3,100,146,4,6,6,5,3,1,0,2,1,3
Nepal,111,11,2013,2010.3,100,147,9,1,11,0,3,0,4,1,2,0
Aruba,90,1,2013,2010.3,89,148,1,1,1,0,0,0,1,1,0,0
Laos,87,8,2013,2010.3,79,149,4,1,8,0,1,0,1,1,2,0
Kyrgyzstan,80,7,2013,2010.3,73,150,5,4,4,3,3,0,1,3,1,1
Montenegro,73,11,2013,2010.3,62,151,3,5,3,8,0,2,2,1,1,2
Mauritania,71,5,2013,2010.3,66,152,1,7,2,3,1,2,0,2,0,3
Nicaragua,64,2,2013,2010.3,62,153,1,2,1,1,0,0,1,1,0,1
Guam,63,2,2013,2010.3,61,154,1,2,0,2,0,1,1,1,0,0
Liechtenstein,63,4,2013,2010.3,59,155,5,4,4,0,0,0,3,4,2,0
Equatorial Guinea,60,5,2013,2010.3,55,156,4,2,3,2,0,0,2,2,2,0
Macau,58,0,2013,2010.3,58,157,1,2,0,0,0,0,1,2,0,0
Afghanistan,52,15,2013,2010.3,37,158,4,5,7,8,3,3,0,1,1,1
Central African Republic,52,3,2013,2010.3,49,159,2,3,1,2,0,0,2,2,0,1
Seychelles,49,7,2013,2010.3,42,160,2,2,5,2,2,0,0,2,0,0
Belize,44,3,2013,2010.3,41,161,2,8,0,3,0,1,0,6,2,1
Eritrea,39,0,2013,2010.3,39,162,1,2,0,0,0,0,1,2,0,0
Somalia,39,0,2013,2010.3,39,163,2,1,0,0,0,0,2,1,0,0
Mongolia,31,1,2013,2010.3,30,164,1,2,0,1,0,0,1,1,0,1
Andorra,30,1,2013,2010.3,29,165,3,4,0,1,0,0,3,3,0,1
Bhutan,22,4,2013,2010.3,18,166,1,2,2,2,0,0,1,2,0,0
San Marino,17,1,2013,2010.3,16,167,3,4,1,0,0,0,3,4,0,0
Bonaire,9,2,2013,2010.3,7,168,1,1,0,2,0,1,1,0,0,0
Northern Mariana Islands,7,0,2013,2010.3,7,169,1,2,0,0,0,0,1,2,0,0
South Sudan,3,1,2013,2010.3,2,170,1,1,0,1,0,0,1,1,0,0
Falkland Islands,1,0,2013,2010.3,1,171,1,1,0,0,0,0,1,1,0,0
Germany,2408,37,2014,2010.4,2371,1,12,5,27,10,7,4,1,1,4,0
Sweden,1884,12,2014,2010.4,1872,2,4,7,5,7,2,2,1,3,1,2
Brazil,1800,33,2014,2010.4,1767,3,9,5,16,17,5,5,2,0,2,0
Hungary,1741,12,2014,2010.4,1729,4,7,2,10,2,3,1,3,0,1,1
England,1663,23,2014,2010.4,1640,5,6,7,14,9,5,3,1,1,0,3
Argentina,1616,24,2014,2010.4,1592,6,7,7,10,14,6,3,1,2,0,2
Netherlands,1441,31,2014,2010.4,1410,7,10,7,19,12,6,3,1,4,3,0
South Korea,1309,13,2014,2010.4,1296,8,7,8,8,5,2,3,5,4,0,1
Denmark,1296,10,2014,2010.4,1286,9,4,5,4,6,2,1,2,2,0,2
France,1282,34,2014,2010.4,1248,10,11,4,25,9,8,2,1,0,2,2
Austria,1258,10,2014,2010.4,1248,11,6,2,6,4,2,2,1,0,3,0
Mexico,1240,19,2014,2010.4,1221,12,7,5,10,9,5,2,1,2,1,1
Czech Republic,1239,15,2014,2010.4,1224,13,5,3,7,8,2,2,2,0,1,1
Poland,1197,21,2014,2010.4,1176,14,4,5,6,15,2,4,1,0,1,1
Italy,1195,12,2014,2010.4,1183,15,8,4,7,5,3,3,2,1,3,0
Scotland,1178,9,2014,2010.4,1169,16,3,4,3,6,2,1,1,1,0,2
Spain,1164,22,2014,2010.4,1142,17,7,5,12,10,4,3,3,2,0,0
Uruguay,1162,18,2014,2010.4,1144,18,4,8,7,11,2,5,1,1,1,2
Belgium,1146,27,2014,2010.4,1119,19,10,3,24,3,8,2,0,1,2,0
Norway,1104,11,2014,2010.4,1093,20,6,6,3,8,1,3,3,2,2,1
Russia,1035,20,2014,2010.4,1015,21,7,6,15,5,5,1,0,2,2,3
Switzerland,1016,20,2014,2010.4,996,22,7,4,13,7,4,2,2,2,1,0
Romania,937,10,2014,2010.4,927,23,5,3,6,4,2,3,1,0,2,0
Zambia,932,15,2014,2010.4,917,24,6,4,10,5,4,1,0,2,2,1
China,891,14,2014,2010.4,877,25,10,1,13,1,4,0,1,1,5,0
Trinidad and Tobago,881,12,2014,2010.4,869,26,3,4,9,3,3,1,0,2,0,1
Chile,879,12,2014,2010.4,867,27,3,6,8,4,2,2,1,2,0,2
Paraguay,860,7,2014,2010.4,853,28,2,5,2,5,1,1,0,3,1,1
Ghana,855,24,2014,2010.4,831,29,8,11,15,9,5,3,1,4,2,4
Egypt,854,8,2014,2010.4,846,30,4,4,3,5,2,1,2,2,0,1
Costa Rica,839,22,2014,2010.4,817,31,7,7,8,14,1,4,2,1,4,2
Bulgaria,837,7,2014,2010.4,830,32,4,2,4,3,1,1,1,1,2,0
Saudi Arabia,833,17,2014,2010.4,816,33,9,4,14,3,5,0,1,4,3,0
Portugal,830,19,2014,2010.4,811,34,6,6,9,10,4,3,1,2,1,1
Japan,829,25,2014,2010.4,804,35,11,2,21,4,6,1,3,1,2,0
Ivory Coast,800,22,2014,2010.4,778,36,5,8,12,10,3,2,1,4,1,2
Finland,791,11,2014,2010.4,780,37,5,5,5,6,1,2,2,2,2,1
Thailand,788,22,2014,2010.4,766,38,7,5,15,7,5,2,1,2,1,1
USA,774,15,2014,2010.4,759,39,7,5,10,5,3,2,2,3,2,0
Indonesia,744,19,2014,2010.4,725,40,7,6,14,5,5,1,1,3,1,2
Iraq,734,7,2014,2010.4,727,41,5,5,5,2,1,1,2,1,2,3
Kuwait,733,17,2014,2010.4,716,42,6,10,7,10,1,2,3,3,2,5
Wales,730,7,2014,2010.4,723,43,2,3,5,2,2,1,0,1,0,1
Nigeria,727,29,2014,2010.4,698,44,8,11,17,12,3,4,2,4,3,3
Malaysia,713,21,2014,2010.4,692,45,6,8,10,11,2,3,2,4,2,1
Ireland,701,20,2014,2010.4,681,46,6,5,16,4,3,1,3,1,0,3
Tunisia,694,8,2014,2010.4,686,47,3,6,5,3,3,2,0,1,0,3
Iran,692,8,2014,2010.4,684,48,5,4,7,1,3,0,1,1,1,3
Uganda,691,16,2014,2010.4,675,49,9,8,12,4,7,1,1,5,1,2
Australia,689,11,2014,2010.4,678,50,5,6,9,2,1,0,3,5,1,1
Honduras,660,4,2014,2010.4,656,51,4,4,3,1,0,0,3,2,1,2
Kenya,649,1,2014,2010.4,648,52,2,4,0,1,0,0,0,3,2,1
Cameroon,638,17,2014,2010.4,621,53,7,7,9,8,4,2,2,3,1,2
Morocco,626,26,2014,2010.4,600,54,9,4,25,1,6,0,1,2,2,2
Turkey,616,12,2014,2010.4,604,55,4,5,6,6,2,2,2,2,0,1
Peru,614,7,2014,2010.4,607,56,1,5,2,5,1,2,0,3,0,0
Malawi,597,11,2014,2010.4,586,57,7,7,10,1,4,0,2,5,1,2
Northern Ireland,596,6,2014,2010.4,590,58,1,5,2,4,1,2,0,2,0,1
Singapore,591,19,2014,2010.4,572,59,8,4,15,4,4,0,3,3,1,1
United Arab Emirates,584,16,2014,2010.4,568,60,7,7,8,8,3,1,1,2,3,4
Jamaica,583,8,2014,2010.4,575,61,3,4,3,5,0,1,1,3,2,0
Greece,580,6,2014,2010.4,574,62,7,6,2,4,1,1,5,1,1,4
Colombia,576,21,2014,2010.4,555,63,6,4,13,8,4,3,0,1,2,0
Senegal,572,12,2014,2010.4,560,64,3,6,5,7,2,2,0,1,1,3
Algeria,564,25,2014,2010.4,539,65,5,8,10,15,4,5,0,3,1,0
Qatar,563,27,2014,2010.4,536,66,10,7,21,6,6,2,1,0,3,5
Guinea,557,14,2014,2010.4,543,67,3,5,5,9,2,3,0,2,1,0
Mali,553,20,2014,2010.4,533,68,7,7,11,9,3,3,3,3,1,1
Democratic Republic of the Congo,543,13,2014,2010.4,530,69,6,4,7,6,3,2,3,2,0,0
Ecuador,525,11,2014,2010.4,514,70,2,5,2,9,0,2,0,2,2,1
Israel,503,11,2014,2010.4,492,71,1,3,1,10,0,3,1,0,0,0
El Salvador,500,5,2014,2010.4,495,72,3,1,3,2,1,1,2,0,0,0
Zimbabwe,489,14,2014,2010.4,475,73,6,7,4,10,1,4,1,3,4,0
Oman,481,19,2014,2010.4,462,74,7,7,9,10,2,3,3,1,2,3
Bahrain,474,7,2014,2010.4,467,75,6,5,6,1,2,1,1,1,3,3
Haiti,468,7,2014,2010.4,461,76,3,2,2,5,0,2,1,0,2,0
Myanmar,450,18,2014,2010.4,432,77,2,10,4,14,1,5,1,4,0,1
New Zealand,445,4,2014,2010.4,441,78,1,4,0,4,0,0,0,3,1,1
Tanzania,433,13,2014,2010.4,420,79,5,5,8,5,3,0,1,2,1,3
Latvia,422,5,2014,2010.4,417,80,5,3,4,1,2,0,1,2,2,1
Iceland,420,13,2014,2010.4,407,81,4,5,6,7,3,1,1,3,0,1
Croatia,411,24,2014,2010.4,387,82,6,6,14,10,5,2,1,2,0,2
Estonia,404,8,2014,2010.4,396,83,5,9,5,3,3,2,1,5,1,2
Bolivia,403,4,2014,2010.4,399,84,2,2,4,0,1,0,1,2,0,0
Sudan,401,4,2014,2010.4,397,85,3,4,1,3,1,0,2,4,0,0
Congo,397,14,2014,2010.4,383,86,6,7,9,5,3,3,2,3,1,1
Martinique,395,6,2014,2010.4,389,87,1,5,0,6,0,3,1,0,0,2
Panama,382,6,2014,2010.4,376,88,2,3,4,2,1,0,0,2,1,1
Hong Kong,374,4,2014,2010.4,370,89,2,4,2,2,1,0,1,2,0,2
Ethiopia,372,8,2014,2010.4,364,90,5,6,1,7,0,1,4,5,1,0
South Africa,363,17,2014,2010.4,346,91,8,5,9,8,3,2,2,0,3,3
Togo,358,7,2014,2010.4,351,92,3,3,4,3,1,1,2,2,0,0
Burkina Faso,357,12,2014,2010.4,345,93,7,4,7,5,1,2,1,2,5,0
Jordan,354,11,2014,2010.4,343,94,4,11,3,8,1,3,2,6,1,2
Uzbekistan,352,13,2014,2010.4,339,95,10,3,9,4,4,1,3,1,3,1
Cuba,349,5,2014,2010.4,344,96,2,3,2,3,1,1,1,2,0,0
Angola,346,9,2014,2010.4,337,97,6,4,7,2,2,0,1,1,3,3
Gabon,343,16,2014,2010.4,327,98,6,8,8,8,3,2,1,2,2,4
Curaçao,341,10,2014,2010.4,331,99,4,2,7,3,1,1,2,0,1,1
Libya,337,6,2014,2010.4,331,100,3,6,2,4,1,0,0,2,2,4
Serbia,334,9,2014,2010.4,325,101,3,5,2,7,0,3,2,1,1,1
Slovakia,322,16,2014,2010.4,306,102,4,5,7,9,4,4,0,1,0,0
Lithuania,321,7,2014,2010.4,314,103,3,7,2,5,1,2,1,3,1,2
Ukraine,295,11,2014,2010.4,284,104,6,2,6,5,4,2,1,0,1,0
Cyprus,269,7,2014,2010.4,262,105,3,3,6,1,1,0,1,3,1,0
Vietnam,263,28,2014,2010.4,235,106,9,1,26,2,6,1,2,0,1,0
Mozambique,260,14,2014,2010.4,246,107,6,8,7,7,2,0,2,3,2,5
Lebanon,250,11,2014,2010.4,239,108,1,4,3,8,1,1,0,2,0,1
Slovenia,243,4,2014,2010.4,239,109,2,5,1,3,1,1,1,4,0,0
Belarus,240,17,2014,2010.4,223,110,5,4,10,7,2,1,2,2,1,1
Grenada,235,8,2014,2010.4,227,111,1,3,0,8,0,1,1,1,0,1
Albania,225,11,2014,2010.4,214,112,3,6,3,8,1,3,1,2,1,1
Antigua and Barbuda,206,4,2014,2010.4,202,113,2,2,2,2,1,0,1,1,0,1
Georgia,205,8,2014,2010.4,197,114,5,2,5,3,2,1,3,1,0,0
Malta,202,1,2014,2010.4,201,115,2,5,0,1,0,0,2,4,0,1
Macedonia,200,6,2014,2010.4,194,116,5,4,5,1,2,0,2,3,1,1
St. Kitts and Nevis,200,7,2014,2010.4,193,117,2,1,7,0,1,0,1,0,0,1
Benin,199,7,2014,2010.4,192,118,2,4,3,4,2,1,0,3,0,0
Mauritius,190,0,2014,2010.4,190,119,1,1,0,0,0,0,1,1,0,0
Rwanda,182,8,2014,2010.4,174,120,3,4,6,2,3,1,0,1,0,2
Sierra Leone,181,6,2014,2010.4,175,121,2,6,3,3,2,0,0,5,0,1
Yemen,179,5,2014,2010.4,174,122,6,4,4,1,1,0,1,2,4,2
Liberia,176,1,2014,2010.4,175,123,1,1,1,0,1,0,0,1,0,0
Namibia,175,2,2014,2010.4,173,124,3,1,2,0,1,0,1,1,1,0
Guyana,172,0,2014,2010.4,172,125,1,1,0,0,0,0,0,1,1,0
Turkmenistan,169,6,2014,2010.4,163,126,2,1,5,1,1,0,1,1,0,0
Palestine,166,22,2014,2010.4,144,127,4,9,11,11,4,4,0,3,0,2
Philippines,161,34,2014,2010.4,127,128,11,8,26,8,6,3,2,4,3,1
Botswana,160,11,2014,2010.4,149,129,8,6,9,2,5,0,2,3,1,3
Luxembourg,160,5,2014,2010.4,155,130,4,3,1,4,0,0,2,2,2,1
Kazakhstan,159,14,2014,2010.4,145,131,5,3,12,2,2,0,1,3,2,0
Moldova,157,12,2014,2010.4,145,132,7,5,8,4,1,1,5,3,1,1
Tajikistan,156,7,2014,2010.4,149,133,1,3,4,3,1,0,0,3,0,0
St. Lucia,150,8,2014,2010.4,142,134,6,4,4,4,1,2,4,2,1,0
Lesotho,148,6,2014,2010.4,142,135,7,6,4,2,2,0,2,5,3,1
Niger,147,8,2014,2010.4,139,136,4,5,4,4,1,0,1,3,2,2
Armenia,146,8,2014,2010.4,138,137,4,5,6,2,1,0,2,5,1,0
Cambodia,139,6,2014,2010.4,133,138,2,5,1,5,1,0,1,5,0,0
Burundi,135,10,2014,2010.4,125,139,5,4,7,3,2,1,1,1,2,2
Swaziland,135,2,2014,2010.4,133,140,2,3,1,1,0,1,1,1,1,1
Azerbaijan,128,3,2014,2010.4,125,141,3,4,1,2,0,1,2,3,1,0
Bangladesh,128,4,2014,2010.4,124,142,2,1,2,2,1,0,0,0,1,1
Dominica,126,4,2014,2010.4,122,143,2,2,4,0,0,0,2,1,0,1
Cape Verde,120,9,2014,2010.4,111,144,3,4,6,3,3,1,0,2,0,1
Faroe Islands,118,6,2014,2010.4,112,145,2,3,1,5,0,2,2,1,0,0
Pakistan,117,1,2014,2010.4,116,146,1,2,0,1,0,0,1,2,0,0
Guinea-Bissau,100,4,2014,2010.4,96,147,2,2,4,0,1,0,0,1,1,1
Laos,98,11,2014,2010.4,87,148,4,6,8,3,2,0,2,5,0,1
Kyrgyzstan,84,4,2014,2010.4,80,149,1,6,1,3,1,0,0,4,0,2
Mauritania,80,9,2014,2010.4,71,150,5,5,5,4,2,1,2,4,1,0
Montenegro,77,4,2014,2010.4,73,151,4,3,4,0,2,0,0,2,2,1
Chad,74,3,2014,2010.4,71,152,1,2,3,0,1,0,0,1,0,1
Guam,72,9,2014,2010.4,63,153,4,2,7,2,2,0,0,1,2,1
Liechtenstein,65,2,2014,2010.4,63,154,2,4,1,1,0,1,1,3,1,0
Macau,64,6,2014,2010.4,58,155,2,2,5,1,1,0,0,1,1,1
Nicaragua,64,0,2014,2010.4,64,156,1,2,0,0,0,0,1,2,0,0
Equatorial Guinea,63,3,2014,2010.4,60,157,1,1,3,0,1,0,0,1,0,0
Afghanistan,59,7,2014,2010.4,52,158,4,4,4,3,2,0,0,2,2,2
Central African Republic,53,1,2014,2010.4,52,159,1,2,0,1,0,0,0,2,1,0
Seychelles,53,4,2014,2010.4,49,160,2,2,4,0,1,0,1,2,0,0
British Virgin Islands,50,2,2014,2010.4,48,161,2,1,2,0,0,0,2,1,0,0
Mongolia,37,6,2014,2010.4,31,162,1,2,4,2,1,0,0,2,0,0
Andorra,32,2,2014,2010.4,30,163,4,2,2,0,0,0,4,2,0,0
Brunei,23,3,2014,2010.4,20,164,1,2,1,2,0,0,1,2,0,0
San Marino,17,0,2014,2010.4,17,165,4,1,0,0,0,0,3,1,1,0
Gibraltar,16,3,2014,2010.4,13,166,5,3,2,1,1,0,4,2,0,1
São Tomé and Príncipe,15,0,2014,2010.4,15,167,1,1,0,0,0,0,1,1,0,0
Bonaire,13,4,2014,2010.4,9,168,1,1,1,3,0,1,1,0,0,0
Comoros,9,2,2014,2010.4,7,169,1,1,1,1,0,0,0,0,1,1
Northern Mariana Islands,9,2,2014,2010.4,7,170,1,2,2,0,1,0,0,2,0,0
South Sudan,3,0,2014,2010.4,3,171,1,1,0,0,0,0,0,1,1,0
Germany,2428,20,2015,2010.5,2408,1,4,5,8,12,2,3,1,2,1,0
Sweden,1903,19,2015,2010.5,1884,2,6,6,13,6,5,2,1,2,0,2
Brazil,1820,20,2015,2010.5,1800,3,9,4,15,5,7,2,1,1,1,1
Hungary,1755,14,2015,2010.5,1741,4,5,4,8,6,3,2,0,1,2,1
England,1686,23,2015,2010.5,1663,5,4,6,10,13,4,3,0,1,0,2
Argentina,1630,14,2015,2010.5,1616,6,7,4,11,3,3,1,1,0,3,3
Netherlands,1456,15,2015,2010.5,1441,7,5,4,8,7,1,3,3,1,1,0
South Korea,1353,44,2015,2010.5,1309,8,10,9,27,17,9,7,0,1,1,1
Denmark,1307,11,2015,2010.5,1296,9,6,4,10,1,3,0,1,3,2,1
France,1299,17,2015,2010.5,1282,10,6,4,14,3,4,2,2,2,0,0
Austria,1276,18,2015,2010.5,1258,11,3,4,5,13,2,4,1,0,0,0
Mexico,1272,32,2015,2010.5,1240,12,7,10,15,17,3,4,1,2,3,4
Czech Republic,1253,14,2015,2010.5,1239,13,4,5,7,7,2,2,1,3,1,0
Poland,1222,25,2015,2010.5,1197,14,6,3,21,4,5,0,0,1,1,2
Italy,1209,14,2015,2010.5,1195,15,6,4,7,7,3,1,1,1,2,2
Scotland,1197,19,2015,2010.5,1178,16,5,3,12,7,3,1,1,1,1,1
Spain,1178,14,2015,2010.5,1164,17,5,4,11,3,5,3,0,1,0,0
Uruguay,1177,15,2015,2010.5,1162,18,5,5,13,2,4,1,0,3,1,1
Belgium,1167,21,2015,2010.5,1146,19,3,5,11,10,3,4,0,1,0,0
Norway,1112,8,2015,2010.5,1104,20,5,4,4,4,2,1,1,3,2,0
Russia,1056,21,2015,2010.5,1035,21,7,3,9,12,4,3,2,0,1,0
Switzerland,1040,24,2015,2010.5,1016,22,5,5,17,7,4,3,0,2,1,0
Zambia,953,21,2015,2010.5,932,23,12,9,17,4,6,2,2,4,4,3
Romania,944,7,2015,2010.5,937,24,3,4,2,5,1,1,0,0,2,3
China,923,32,2015,2010.5,891,25,9,5,25,7,4,2,1,2,4,1
Chile,905,26,2015,2010.5,879,26,11,3,22,4,7,1,1,2,3,0
Trinidad and Tobago,891,10,2015,2010.5,881,27,5,2,10,0,2,0,1,2,2,0
Ghana,884,29,2015,2010.5,855,28,10,8,20,9,6,4,3,2,1,2
Egypt,873,19,2015,2010.5,854,29,5,2,14,5,5,1,0,1,0,0
Paraguay,873,13,2015,2010.5,860,30,4,8,5,8,2,1,0,4,2,3
Japan,868,39,2015,2010.5,829,31,9,7,22,17,6,5,0,0,3,2
Costa Rica,847,8,2015,2010.5,839,32,4,6,4,4,1,0,1,4,2,2
Saudi Arabia,844,11,2015,2010.5,833,33,4,4,7,4,3,1,1,2,0,1
Bulgaria,842,5,2015,2010.5,837,34,3,4,4,1,1,1,1,3,1,0
Portugal,842,12,2015,2010.5,830,35,4,6,3,9,2,5,2,1,0,0
Ivory Coast,820,20,2015,2010.5,800,36,8,9,12,8,4,5,0,2,4,2
Thailand,806,18,2015,2010.5,788,37,8,1,15,3,5,1,1,0,2,0
USA,803,29,2015,2010.5,774,38,9,5,18,11,5,2,2,2,2,1
Finland,797,6,2015,2010.5,791,39,5,4,3,3,2,1,2,1,1,2
Iraq,756,22,2015,2010.5,734,40,6,9,12,10,4,2,2,4,0,3
Kuwait,749,16,2015,2010.5,733,41,5,6,10,6,1,2,3,3,1,1
Nigeria,741,14,2015,2010.5,727,42,8,5,11,3,5,1,3,0,0,4
Wales,739,9,2015,2010.5,730,43,4,2,5,4,2,2,1,0,1,0
Iran,725,33,2015,2010.5,692,44,7,8,17,16,5,5,0,1,2,2
Australia,722,33,2015,2010.5,689,45,8,6,22,11,7,3,1,1,0,2
Tunisia,720,26,2015,2010.5,694,46,7,8,18,8,3,2,1,3,3,3
Malaysia,717,4,2015,2010.5,713,47,5,4,1,3,0,1,3,3,2,0
Uganda,711,20,2015,2010.5,691,48,7,8,12,8,6,5,0,2,1,1
Ireland,710,9,2015,2010.5,701,49,5,2,4,5,2,1,0,1,3,0
Honduras,673,13,2015,2010.5,660,50,6,6,5,8,1,2,3,3,2,1
Kenya,661,12,2015,2010.5,649,51,5,6,6,6,3,1,0,2,2,3
Cameroon,655,17,2015,2010.5,638,52,7,8,4,13,1,5,1,1,5,2
Morocco,644,18,2015,2010.5,626,53,7,4,8,10,3,3,2,1,2,0
Turkey,633,17,2015,2010.5,616,54,5,5,9,8,3,4,0,0,2,1
Peru,626,12,2015,2010.5,614,55,5,6,7,5,3,1,2,4,0,1
United Arab Emirates,613,29,2015,2010.5,584,56,4,9,20,9,4,3,0,4,0,2
Malawi,612,15,2015,2010.5,597,57,4,11,6,9,3,2,1,5,0,4
Northern Ireland,608,12,2015,2010.5,596,58,6,3,8,4,3,1,0,1,3,1
Singapore,608,17,2015,2010.5,591,59,6,6,11,6,3,2,2,3,1,1
Qatar,600,37,2015,2010.5,563,60,9,6,28,9,6,3,3,2,0,1
Senegal,599,27,2015,2010.5,572,61,7,7,18,9,6,3,1,2,0,2
Jamaica,594,11,2015,2010.5,583,62,4,7,6,5,3,2,1,4,0,1
Algeria,593,29,2015,2010.5,564,63,5,8,16,13,4,3,1,3,0,2
Colombia,590,14,2015,2010.5,576,64,5,6,3,11,2,3,2,1,1,2
Greece,586,6,2015,2010.5,580,65,2,7,4,2,1,0,1,3,0,4
Guinea,575,18,2015,2010.5,557,66,5,8,9,9,3,2,1,3,1,3
Mali,572,19,2015,2010.5,553,67,5,7,7,12,3,1,1,2,1,4
Democratic Republic of the Congo,568,25,2015,2010.5,543,68,6,12,11,14,3,4,1,4,2,4
Ecuador,545,20,2015,2010.5,525,69,5,5,12,8,4,3,1,1,0,1
Guatemala,518,3,2015,2010.5,515,70,2,5,0,3,0,0,1,4,1,1
Israel,509,6,2015,2010.5,503,71,4,2,5,1,1,0,3,1,0,1
El Salvador,504,4,2015,2010.5,500,72,4,3,2,2,1,1,1,1,2,1
Oman,504,23,2015,2010.5,481,73,10,7,19,4,6,1,3,4,1,2
Zimbabwe,501,12,2015,2010.5,489,74,3,4,7,5,3,2,0,1,0,1
Syria,490,29,2015,2010.5,461,75,3,8,6,23,2,6,1,1,0,1
Bahrain,488,14,2015,2010.5,474,76,7,5,6,8,3,2,3,2,1,1
Haiti,475,7,2015,2010.5,468,77,1,6,0,7,0,2,1,2,0,2
Myanmar,460,10,2015,2010.5,450,78,5,7,7,3,2,0,2,6,1,1
Tanzania,447,14,2015,2010.5,433,79,7,10,6,8,1,2,3,6,3,2
Iceland,435,15,2015,2010.5,420,80,3,8,4,11,1,3,0,3,2,2
Croatia,428,17,2015,2010.5,411,81,4,4,13,4,3,2,0,1,1,1
Latvia,428,6,2015,2010.5,422,82,3,5,1,5,0,0,3,1,0,4
India,421,15,2015,2010.5,406,83,8,4,13,2,5,0,2,3,1,1
Congo,420,23,2015,2010.5,397,84,7,6,11,12,3,3,3,1,1,2
Estonia,416,12,2015,2010.5,404,85,6,4,10,2,4,1,1,3,1,0
Bolivia,412,9,2015,2010.5,403,86,3,5,5,4,1,1,1,3,1,1
Sudan,409,8,2015,2010.5,401,87,4,8,2,6,1,1,3,3,0,4
Ethiopia,396,24,2015,2010.5,372,88,12,5,18,6,5,1,3,3,4,1
Hong Kong,395,21,2015,2010.5,374,89,7,5,19,2,5,2,1,1,1,2
Panama,393,11,2015,2010.5,382,90,4,8,5,6,1,1,1,2,2,5
South Africa,389,26,2015,2010.5,363,91,12,9,11,15,5,4,2,2,5,3
Jordan,382,28,2015,2010.5,354,92,10,7,15,13,5,3,2,4,3,0
Burkina Faso,373,16,2015,2010.5,357,93,7,8,12,4,3,1,3,4,1,3
Uzbekistan,371,19,2015,2010.5,352,94,3,7,4,15,2,3,1,3,0,1
Togo,364,6,2015,2010.5,358,95,3,5,3,3,1,1,1,3,1,1
Angola,361,15,2015,2010.5,346,96,6,6,10,5,4,1,2,3,0,2
Gabon,361,18,2015,2010.5,343,97,7,9,10,8,3,2,3,4,1,3
Cuba,354,5,2015,2010.5,349,98,1,10,1,4,0,2,0,7,1,1
Curaçao,351,10,2015,2010.5,341,99,6,3,7,3,3,0,1,1,2,2
Serbia,346,12,2015,2010.5,334,100,3,5,7,5,2,1,1,4,0,0
Libya,344,7,2015,2010.5,337,101,3,5,2,5,1,2,2,3,0,0
Slovakia,338,16,2015,2010.5,322,102,7,2,12,4,5,1,1,1,1,0
Canada,328,3,2015,2010.5,325,103,4,2,3,0,1,0,1,1,2,1
Lithuania,325,4,2015,2010.5,321,104,3,5,3,1,1,0,2,4,0,1
Ukraine,309,14,2015,2010.5,295,105,5,5,9,5,3,2,1,1,1,2
Venezuela,290,11,2015,2010.5,279,106,4,7,2,9,0,3,3,4,1,0
Cyprus,274,5,2015,2010.5,269,107,2,3,0,5,0,2,2,1,0,0
Mozambique,273,13,2015,2010.5,260,108,5,6,9,4,2,2,1,4,2,0
Lebanon,266,16,2015,2010.5,250,109,6,5,11,5,1,3,3,0,2,2
Vietnam,264,1,2015,2010.5,263,110,2,1,1,0,0,0,1,1,1,0
Slovenia,258,15,2015,2010.5,243,111,5,4,11,4,2,1,1,3,2,0
Belarus,248,8,2015,2010.5,240,112,4,4,2,6,1,2,1,2,2,0
Grenada,241,6,2015,2010.5,235,113,3,3,4,2,1,1,2,2,0,0
Fiji,239,13,2015,2010.5,226,114,2,2,11,2,2,0,0,1,0,1
Albania,233,8,2015,2010.5,225,115,5,2,5,3,2,1,2,0,1,1
Georgia,216,11,2015,2010.5,205,116,5,5,8,3,3,0,2,4,0,1
Macedonia,206,6,2015,2010.5,200,117,6,3,5,1,1,0,4,2,1,1
Malta,206,4,2015,2010.5,202,118,4,5,4,0,1,0,2,5,1,0
Benin,203,4,2015,2010.5,199,119,1,3,2,2,1,0,0,2,0,1
Mauritius,198,8,2015,2010.5,190,120,4,6,6,2,1,1,1,4,2,1
Rwanda,195,13,2015,2010.5,182,121,10,5,11,2,3,2,4,3,3,0
Namibia,192,17,2015,2010.5,175,122,10,6,15,2,6,0,2,4,2,2
Sierra Leone,184,3,2015,2010.5,181,123,2,3,2,1,1,0,0,3,1,0
Yemen,184,5,2015,2010.5,179,124,6,4,4,1,1,1,4,2,1,1
Liberia,183,7,2015,2010.5,176,125,3,4,2,5,1,1,1,3,1,0
Palestine,181,15,2015,2010.5,166,126,4,5,7,8,1,1,1,3,2,1
Madagascar,180,19,2015,2010.5,161,127,7,5,12,7,3,2,0,3,4,0
Turkmenistan,178,9,2015,2010.5,169,128,4,4,6,3,3,0,0,4,1,0
Botswana,175,15,2015,2010.5,160,129,8,6,12,3,4,1,4,3,0,2
Philippines,169,8,2015,2010.5,161,130,4,3,5,3,2,1,2,2,0,0
Tajikistan,169,13,2015,2010.5,156,131,4,4,8,5,1,1,3,1,0,2
Maldives,167,13,2015,2010.5,154,132,4,8,3,10,1,2,3,6,0,0
Luxembourg,165,5,2015,2010.5,160,133,6,4,5,0,2,0,3,4,1,0
Kazakhstan,163,4,2015,2010.5,159,134,5,4,2,2,0,1,3,1,2,2
Moldova,161,4,2015,2010.5,157,135,3,6,1,3,0,0,3,3,0,3
Niger,159,12,2015,2010.5,147,136,6,5,9,3,4,1,1,2,1,2
Lesotho,156,8,2015,2010.5,148,137,9,4,6,2,1,0,3,3,5,1
Cambodia,155,16,2015,2010.5,139,138,9,5,13,3,4,0,4,4,1,1
Swaziland,155,20,2015,2010.5,135,139,5,8,7,13,1,4,1,3,3,1
Armenia,149,3,2015,2010.5,146,140,3,3,2,1,0,0,2,3,1,0
Sri Lanka,149,2,2015,2010.5,147,141,1,5,0,2,0,1,1,4,0,0
Burundi,146,11,2015,2010.5,135,142,2,8,4,7,1,2,1,4,0,2
Gambia,145,5,2015,2010.5,140,143,2,4,2,3,1,0,0,2,1,2
Bangladesh,138,10,2015,2010.5,128,144,9,6,7,3,2,1,5,4,2,1
Cape Verde,137,17,2015,2010.5,120,145,5,4,12,5,3,2,0,1,2,1
Azerbaijan,136,8,2015,2010.5,128,146,4,4,5,3,2,0,1,2,1,2
Dominica,128,2,2015,2010.5,126,147,1,2,0,2,0,1,0,1,1,0
Faroe Islands,122,4,2015,2010.5,118,148,3,3,3,1,1,0,2,3,0,0
Pakistan,120,3,2015,2010.5,117,149,2,1,2,1,1,0,0,1,1,0
Nepal,112,1,2015,2010.5,111,150,2,4,0,1,0,0,1,3,1,1
Laos,105,7,2015,2010.5,98,151,7,4,5,2,1,0,5,3,1,1
Guinea-Bissau,104,4,2015,2010.5,100,152,2,2,3,1,0,0,2,0,0,2
Mauritania,96,16,2015,2010.5,80,153,6,5,13,3,4,0,1,4,1,1
Kyrgyzstan,93,9,2015,2010.5,84,154,4,3,6,3,2,1,1,1,1,1
Montenegro,86,9,2015,2010.5,77,155,3,5,4,5,1,1,2,4,0,0
Afghanistan,85,26,2015,2010.5,59,156,6,8,16,10,4,3,2,4,0,1
Chad,80,6,2015,2010.5,74,157,3,5,3,3,2,1,1,4,0,0
Guam,77,5,2015,2010.5,72,158,4,5,3,2,2,0,1,4,1,1
Nicaragua,76,12,2015,2010.5,64,159,2,2,6,6,2,2,0,0,0,0
Equatorial Guinea,72,9,2015,2010.5,63,160,8,5,7,2,3,1,1,3,4,1
Liechtenstein,67,2,2015,2010.5,65,161,5,3,2,0,1,0,3,3,1,0
Macau,65,1,2015,2010.5,64,162,1,2,1,0,0,0,0,2,1,0
Central African Republic,57,4,2015,2010.5,53,163,1,3,2,2,1,0,0,2,0,1
Seychelles,55,2,2015,2010.5,53,164,4,4,1,1,0,0,3,3,1,1
Eritrea,40,1,2015,2010.5,39,165,1,1,0,1,0,0,1,1,0,0
Somalia,39,0,2015,2010.5,39,166,2,3,0,0,0,0,2,3,0,0
Tonga,38,1,2015,2010.5,37,167,3,1,1,0,0,0,3,1,0,0
Samoa,35,6,2015,2010.5,29,168,1,2,3,3,1,1,0,1,0,0
Andorra,34,2,2015,2010.5,32,169,4,2,2,0,0,0,4,2,0,0
Bhutan,29,7,2015,2010.5,22,170,7,6,5,2,1,1,6,5,0,0
Djibouti,28,3,2015,2010.5,25,171,4,4,1,2,0,0,4,4,0,0
Cook Islands,27,4,2015,2010.5,23,172,1,2,1,3,1,1,0,1,0,0
Brunei,25,2,2015,2010.5,23,173,1,2,0,2,0,0,1,2,0,0
Montserrat,24,3,2015,2010.5,21,174,1,1,2,1,0,0,0,1,1,0
Gibraltar,18,2,2015,2010.5,16,175,4,4,0,2,0,0,3,4,1,0
San Marino,18,1,2015,2010.5,17,176,2,5,0,1,0,0,2,5,0,0
São Tomé and Príncipe,17,2,2015,2010.5,15,177,2,2,1,1,1,0,1,2,0,0
American Samoa,13,6,2015,2010.5,7,178,1,3,2,4,1,1,0,2,0,0
Åland Islands,11,0,2015,2010.5,11,179,1,1,0,0,0,0,1,0,0,1
Comoros,10,1,2015,2010.5,9,180,3,4,0,1,0,0,1,3,2,1
South Sudan,9,6,2015,2010.5,3,181,6,3,6,0,3,0,0,3,3,0
Germany,2462,34,2016,2010.6,2428,1,11,5,22,12,7,3,2,1,2,1
Sweden,1919,16,2016,2010.6,1903,2,8,5,12,4,3,1,1,3,4,1
Brazil,1848,28,2016,2010.6,1820,3,7,4,19,9,4,3,1,0,2,1
Hungary,1770,15,2016,2010.6,1755,4,6,5,10,5,1,2,2,1,3,2
England,1707,21,2016,2010.6,1686,5,10,4,17,4,6,2,2,0,2,2
Argentina,1660,30,2016,2010.6,1630,6,9,5,20,10,7,2,1,1,1,2
Netherlands,1475,19,2016,2010.6,1456,7,5,6,8,11,1,4,3,0,1,2
South Korea,1368,15,2016,2010.6,1353,8,5,5,11,4,5,2,0,2,0,1
France,1335,36,2016,2010.6,1299,9,13,4,29,7,10,3,1,0,2,1
Denmark,1326,19,2016,2010.6,1307,10,5,4,12,7,4,1,1,2,0,1
Mexico,1290,18,2016,2010.6,1272,11,9,3,12,6,6,2,1,0,2,1
Austria,1288,12,2016,2010.6,1276,12,8,4,7,5,2,1,4,2,2,1
Czech Republic,1271,18,2016,2010.6,1253,13,11,3,17,1,4,0,3,2,4,1
Poland,1244,22,2016,2010.6,1222,14,9,5,15,7,5,2,1,0,3,3
Italy,1232,23,2016,2010.6,1209,15,9,6,9,14,4,4,2,1,3,1
Spain,1209,31,2016,2010.6,1178,16,6,8,22,9,5,2,1,2,0,4
Scotland,1205,8,2016,2010.6,1197,17,2,6,2,6,1,2,0,4,1,0
Belgium,1201,34,2016,2010.6,1167,18,6,8,15,19,3,5,2,2,1,1
Uruguay,1196,19,2016,2010.6,1177,19,6,5,13,6,5,0,1,3,0,2
Norway,1124,12,2016,2010.6,1112,20,5,5,9,3,3,0,2,4,0,1
Russia,1071,15,2016,2010.6,1056,21,7,5,10,5,3,0,3,3,1,2
Switzerland,1055,15,2016,2010.6,1040,22,5,6,8,7,3,3,1,1,1,2
Zambia,964,11,2016,2010.6,953,23,6,10,3,8,0,4,1,3,5,3
Romania,962,18,2016,2010.6,944,24,9,4,12,6,2,1,3,2,4,1
Chile,935,30,2016,2010.6,905,25,6,8,15,15,5,3,1,3,0,2
China,935,12,2016,2010.6,923,26,7,2,10,2,3,0,2,2,2,0
Trinidad and Tobago,904,13,2016,2010.6,891,27,3,5,6,7,1,1,1,4,1,0
Japan,897,29,2016,2010.6,868,28,7,2,26,3,6,1,1,0,0,1
Ghana,891,7,2016,2010.6,884,29,3,5,4,3,1,1,0,2,2,2
Egypt,886,13,2016,2010.6,873,30,6,4,8,5,4,2,1,1,1,1
Portugal,884,42,2016,2010.6,842,31,10,7,30,12,7,3,1,2,2,2
Paraguay,882,9,2016,2010.6,873,32,4,8,5,4,1,1,2,5,1,2
Costa Rica,868,21,2016,2010.6,847,33,5,5,12,9,4,3,0,1,1,1
Saudi Arabia,860,16,2016,2010.6,844,34,5,3,12,4,4,1,0,1,1,1
Bulgaria,853,11,2016,2010.6,842,35,3,5,5,6,2,2,1,3,0,0
Ivory Coast,838,18,2016,2010.6,820,36,6,9,11,7,4,3,0,2,2,4
Thailand,830,24,2016,2010.6,806,37,9,7,17,7,5,2,2,4,2,1
USA,826,23,2016,2010.6,803,38,9,4,18,5,6,2,3,2,0,0
Finland,800,3,2016,2010.6,797,39,2,8,0,3,0,0,2,7,0,1
Iraq,767,11,2016,2010.6,756,40,5,6,8,3,2,0,2,5,1,1
Indonesia,763,19,2016,2010.6,744,41,4,7,9,10,3,1,0,3,1,3
Wales,758,19,2016,2010.6,739,42,7,6,13,6,4,1,0,4,3,1
Nigeria,757,16,2016,2010.6,741,43,5,5,10,6,4,2,0,2,1,1
Iran,752,27,2016,2010.6,725,44,6,4,23,4,6,2,0,0,0,2
Australia,745,23,2016,2010.6,722,45,6,4,17,6,4,1,1,1,1,2
Tunisia,740,20,2016,2010.6,720,46,7,4,11,9,3,3,1,0,3,1
Ireland,729,19,2016,2010.6,710,47,7,6,11,8,3,3,1,2,3,1
Malaysia,726,9,2016,2010.6,717,48,5,7,6,3,2,1,1,3,2,3
Uganda,718,7,2016,2010.6,711,49,8,6,3,4,2,1,2,3,4,2
Honduras,685,12,2016,2010.6,673,50,5,3,8,4,4,1,1,0,0,2
Cameroon,671,16,2016,2010.6,655,51,7,7,10,6,3,2,1,1,3,4
Kenya,669,8,2016,2010.6,661,52,6,4,6,2,3,1,1,1,2,2
Morocco,660,16,2016,2010.6,644,53,6,6,10,6,4,2,1,0,1,4
Peru,647,21,2016,2010.6,626,54,5,8,6,15,1,5,1,2,3,1
Turkey,645,12,2016,2010.6,633,55,5,7,5,7,2,3,1,3,2,1
United Arab Emirates,634,21,2016,2010.6,613,56,10,2,19,2,6,1,3,1,1,0
Northern Ireland,623,15,2016,2010.6,608,57,6,7,12,3,4,1,2,3,0,3
Malawi,618,6,2016,2010.6,612,58,4,3,5,1,2,1,2,1,0,1
Qatar,616,16,2016,2010.6,600,59,6,6,10,6,5,1,1,4,0,1
Singapore,616,8,2016,2010.6,608,60,5,8,4,4,2,1,2,6,1,1
Algeria,613,20,2016,2010.6,593,61,3,3,14,6,2,1,0,1,1,1
Colombia,609,19,2016,2010.6,590,62,7,7,11,8,3,4,2,2,2,1
Senegal,609,10,2016,2010.6,599,63,3,2,6,4,3,2,0,0,0,0
Democratic Republic of the Congo,604,36,2016,2010.6,568,64,9,9,22,14,7,4,1,3,1,2
Greece,602,16,2016,2010.6,586,65,4,5,6,10,2,4,2,1,0,0
Jamaica,596,2,2016,2010.6,594,66,4,4,2,0,1,0,2,4,1,0
Guinea,586,11,2016,2010.6,575,67,4,8,3,8,1,1,2,2,1,5
Mali,584,12,2016,2010.6,572,68,4,8,4,8,2,4,0,3,2,1
Ecuador,564,19,2016,2010.6,545,69,6,6,14,5,3,0,1,4,2,2
Guatemala,523,5,2016,2010.6,518,70,2,2,3,2,1,0,1,1,0,1
Zimbabwe,519,18,2016,2010.6,501,71,8,4,16,2,5,0,2,0,1,4
Israel,518,9,2016,2010.6,509,72,2,4,3,6,1,2,1,2,0,0
Oman,512,8,2016,2010.6,504,73,4,4,5,3,2,1,0,3,2,0
El Salvador,509,5,2016,2010.6,504,74,4,2,4,1,0,0,3,2,1,0
Syria,503,13,2016,2010.6,490,75,4,9,8,5,2,3,0,4,2,2
Bahrain,501,13,2016,2010.6,488,76,5,4,8,5,3,1,0,2,2,1
Haiti,481,6,2016,2010.6,475,77,3,6,0,6,0,3,2,3,1,0
Myanmar,470,10,2016,2010.6,460,78,9,3,8,2,3,0,4,2,2,1
Iceland,465,30,2016,2010.6,435,79,5,12,12,18,4,4,0,6,1,2
New Zealand,458,13,2016,2010.6,445,80,4,4,7,6,4,1,0,1,0,2
Croatia,454,26,2016,2010.6,428,81,7,5,18,8,5,3,1,0,1,2
Tanzania,449,2,2016,2010.6,447,82,1,4,0,2,0,1,1,2,0,1
Latvia,440,12,2016,2010.6,428,83,4,5,5,7,2,2,2,1,0,2
India,438,17,2016,2010.6,421,84,4,3,13,4,3,2,1,1,0,0
Estonia,427,11,2016,2010.6,416,85,7,6,7,4,2,1,2,3,3,2
Congo,425,5,2016,2010.6,420,86,3,4,3,2,1,0,1,3,1,1
Bolivia,419,7,2016,2010.6,412,87,4,7,5,2,1,0,2,7,1,0
Hong Kong,412,17,2016,2010.6,395,88,4,4,13,4,4,1,0,2,0,1
Sudan,412,3,2016,2010.6,409,89,2,3,2,1,0,0,1,2,1,1
South Africa,409,20,2016,2010.6,389,90,7,4,12,8,3,1,0,0,4,3
Panama,408,15,2016,2010.6,393,91,5,7,9,6,4,2,0,4,1,1
Martinique,407,12,2016,2010.6,395,92,3,3,5,7,2,2,1,0,0,1
Ethiopia,405,9,2016,2010.6,396,93,3,4,6,3,1,1,1,2,1,1
Jordan,399,17,2016,2010.6,382,94,4,8,10,7,1,2,1,3,2,3
Uzbekistan,385,14,2016,2010.6,371,95,9,3,11,3,8,1,1,2,0,0
Burkina Faso,380,7,2016,2010.6,373,96,3,5,4,3,2,2,0,2,1,1
Togo,373,9,2016,2010.6,364,97,5,3,6,3,3,0,0,2,2,1
Gabon,370,9,2016,2010.6,361,98,5,7,3,6,1,1,1,5,3,1
Angola,368,7,2016,2010.6,361,99,5,6,1,6,0,1,4,4,1,1
Curaçao,365,14,2016,2010.6,351,100,3,2,10,4,3,1,0,1,0,0
Serbia,362,16,2016,2010.6,346,101,4,7,10,6,3,2,0,3,1,2
Cuba,356,2,2016,2010.6,354,102,2,1,2,0,1,0,1,1,0,0
Slovakia,356,18,2016,2010.6,338,103,7,7,10,8,3,2,1,3,3,2
Libya,351,7,2016,2010.6,344,104,3,4,5,2,1,1,1,3,1,0
Canada,339,11,2016,2010.6,328,105,3,6,5,6,2,1,1,4,0,1
Lithuania,333,8,2016,2010.6,325,106,3,6,6,2,2,0,0,4,1,2
Suriname,333,6,2016,2010.6,327,107,2,4,6,0,2,0,0,3,0,1
Ukraine,324,15,2016,2010.6,309,108,7,4,6,9,4,2,2,1,1,1
New Caledonia,305,13,2016,2010.6,292,109,3,5,8,5,1,2,1,2,1,1
Venezuela,305,15,2016,2010.6,290,110,4,9,8,7,1,2,2,5,1,2
Vietnam,288,24,2016,2010.6,264,111,6,6,15,9,4,3,0,2,2,1
Mozambique,279,6,2016,2010.6,273,112,3,6,2,4,1,1,0,5,2,0
Cyprus,278,4,2016,2010.6,274,113,2,3,3,1,1,0,1,3,0,0
Lebanon,272,6,2016,2010.6,266,114,5,5,6,0,1,0,0,3,4,2
Guadeloupe,267,5,2016,2010.6,262,115,3,2,3,2,1,0,0,2,2,0
Slovenia,264,6,2016,2010.6,258,116,4,5,2,4,2,1,1,1,1,3
Belarus,254,6,2016,2010.6,248,117,2,8,1,5,0,3,0,3,2,2
Albania,245,12,2016,2010.6,233,118,7,5,6,6,2,3,4,2,1,0
Fiji,244,5,2016,2010.6,239,119,2,2,3,2,0,1,1,1,1,0
Georgia,223,7,2016,2010.6,216,120,3,5,3,4,0,1,1,3,2,1
Macedonia,214,8,2016,2010.6,206,121,4,4,4,4,0,1,4,3,0,0
Barbados,211,1,2016,2010.6,210,122,1,1,1,0,1,0,0,1,0,0
Benin,211,8,2016,2010.6,203,123,2,1,6,2,2,1,0,0,0,0
Rwanda,210,15,2016,2010.6,195,124,9,2,14,1,4,0,4,1,1,1
Malta,209,3,2016,2010.6,206,125,4,5,1,2,0,0,3,4,1,1
Antigua and Barbuda,208,2,2016,2010.6,206,126,2,2,2,0,1,0,1,2,0,0
St. Kitts and Nevis,205,5,2016,2010.6,200,127,4,1,3,2,2,1,1,0,1,0
Mauritius,201,3,2016,2010.6,198,128,3,4,1,2,1,1,2,3,0,0
Namibia,201,9,2016,2010.6,192,129,4,2,6,3,2,1,1,1,1,0
Liberia,192,9,2016,2010.6,183,130,2,3,7,2,1,1,0,2,1,0
Sierra Leone,188,4,2016,2010.6,184,131,2,2,2,2,2,0,0,1,0,1
Yemen,188,4,2016,2010.6,184,132,1,2,2,2,1,1,0,1,0,0
Palestine,186,5,2016,2010.6,181,133,1,3,1,4,0,0,0,1,1,2
Solomon Islands,186,4,2016,2010.6,182,134,4,3,2,2,1,1,3,2,0,0
Botswana,185,10,2016,2010.6,175,135,5,4,6,4,2,0,1,3,2,1
Madagascar,185,5,2016,2010.6,180,136,3,4,2,3,0,1,1,2,2,1
Maldives,185,18,2016,2010.6,167,137,6,3,17,1,4,0,2,2,0,1
Tajikistan,183,14,2016,2010.6,169,138,6,3,12,2,3,1,1,1,2,1
Guyana,178,6,2016,2010.6,172,139,1,2,2,4,1,0,0,2,0,0
Cambodia,176,21,2016,2010.6,155,140,6,7,13,8,5,0,1,7,0,0
Philippines,175,6,2016,2010.6,169,141,5,2,4,2,1,1,2,1,2,0
Luxembourg,172,7,2016,2010.6,165,142,4,3,2,5,0,0,4,2,0,1
Kazakhstan,169,6,2016,2010.6,163,143,2,6,2,4,0,2,0,3,2,1
Lesotho,169,13,2016,2010.6,156,144,4,6,8,5,2,2,2,3,0,1
Swaziland,166,11,2016,2010.6,155,145,5,4,8,3,4,0,0,2,1,2
Moldova,165,4,2016,2010.6,161,146,2,6,1,3,0,1,2,3,0,2
Armenia,164,15,2016,2010.6,149,147,3,5,3,12,1,2,1,3,1,0
Niger,163,4,2016,2010.6,159,148,3,2,3,1,0,0,2,2,1,0
Sri Lanka,153,4,2016,2010.6,149,149,2,4,2,2,0,0,1,4,1,0
Burundi,150,4,2016,2010.6,146,150,1,1,1,3,0,1,1,0,0,0
Vanuatu,149,3,2016,2010.6,146,151,2,1,0,3,0,1,2,0,0,0
Gambia,146,1,2016,2010.6,145,152,3,2,0,1,0,0,1,2,2,0
Bangladesh,144,6,2016,2010.6,138,153,4,5,4,2,1,0,1,5,2,0
Papua New Guinea,143,13,2016,2010.6,130,154,4,3,11,2,2,0,0,3,2,0
Azerbaijan,140,4,2016,2010.6,136,155,5,3,3,1,1,1,2,1,2,1
Cape Verde,137,0,2016,2010.6,137,156,3,2,0,0,0,0,3,2,0,0
Dominica,137,9,2016,2010.6,128,157,1,2,1,8,0,1,1,1,0,0
Faroe Islands,127,5,2016,2010.6,122,158,2,3,0,5,0,2,1,1,1,0
Laos,124,19,2016,2010.6,105,159,6,7,10,9,2,2,2,4,2,1
Nepal,124,12,2016,2010.6,112,160,4,3,7,5,3,1,0,0,1,2
Guinea-Bissau,106,2,2016,2010.6,104,161,1,2,1,1,1,1,0,1,0,0
Mauritania,101,5,2016,2010.6,96,162,3,4,2,3,1,1,2,0,0,3
Kyrgyzstan,98,5,2016,2010.6,93,163,4,4,4,1,2,1,1,2,1,1
Montenegro,96,10,2016,2010.6,86,164,2,5,5,5,1,1,0,3,1,1
Dominican Republic,92,9,2016,2010.6,83,165,3,2,8,1,2,0,1,2,0,0
Aruba,91,1,2016,2010.6,90,166,1,1,0,1,0,0,1,1,0,0
Afghanistan,89,4,2016,2010.6,85,167,1,5,2,2,1,0,0,4,0,1
Puerto Rico,85,11,2016,2010.6,74,168,2,4,3,8,0,1,2,2,0,1
Nicaragua,79,3,2016,2010.6,76,169,2,1,3,0,1,0,1,1,0,0
Equatorial Guinea,78,6,2016,2010.6,72,170,2,3,4,2,1,0,1,2,0,1
Macau,78,13,2016,2010.6,65,171,3,5,5,8,1,2,0,1,2,2
Liechtenstein,70,3,2016,2010.6,67,172,3,5,2,1,0,0,3,4,0,1
Central African Republic,64,7,2016,2010.6,57,173,2,2,5,2,2,0,0,1,0,1
Seychelles,59,4,2016,2010.6,55,174,3,4,2,2,1,0,2,4,0,0
British Virgin Islands,50,0,2016,2010.6,50,175,1,1,0,0,0,0,1,1,0,0
Mongolia,50,13,2016,2010.6,37,176,3,3,2,11,1,1,2,1,0,1
Andorra,35,1,2016,2010.6,34,177,3,4,1,0,0,0,3,3,0,1
Bhutan,34,5,2016,2010.6,29,178,2,2,3,2,1,0,1,1,0,1
Djibouti,28,0,2016,2010.6,28,179,2,1,0,0,0,0,2,1,0,0
Gibraltar,20,2,2016,2010.6,18,180,4,3,1,1,0,0,3,3,1,0
São Tomé and Príncipe,19,2,2016,2010.6,17,181,1,1,2,0,1,0,0,1,0,0
San Marino,19,1,2016,2010.6,18,182,2,3,0,1,0,0,2,3,0,0
Comoros,15,5,2016,2010.6,10,183,2,4,1,4,1,0,1,2,0,2
South Sudan,11,2,2016,2010.6,9,184,2,2,1,1,0,0,2,2,0,0
Germany,2505,43,2017,2010.7,2462,1,8,7,29,14,6,5,0,0,2,2
Sweden,1945,26,2017,2010.7,1919,2,4,7,15,11,4,2,0,3,0,2
Brazil,1869,21,2017,2010.7,1848,3,4,7,9,12,4,3,0,1,0,3
Hungary,1778,8,2017,2010.7,1770,4,5,4,5,3,3,0,2,4,0,0
England,1721,14,2017,2010.7,1707,5,5,5,5,9,3,2,0,2,2,1
Argentina,1675,15,2017,2010.7,1660,6,5,5,5,10,2,3,1,1,2,1
Netherlands,1500,25,2017,2010.7,1475,7,5,6,16,9,4,4,1,2,0,0
South Korea,1383,15,2017,2010.7,1368,8,6,6,7,8,2,1,1,3,3,2
France,1358,23,2017,2010.7,1335,9,7,4,16,7,5,2,1,1,1,1
Denmark,1345,19,2017,2010.7,1326,10,4,5,6,13,1,4,0,0,3,1
Mexico,1329,39,2017,2010.7,1290,11,14,10,23,16,10,4,2,3,2,3
Austria,1299,11,2017,2010.7,1288,12,5,3,9,2,3,1,0,1,2,1
Czech Republic,1293,22,2017,2010.7,1271,13,3,7,9,13,2,4,1,2,0,1
Poland,1262,18,2017,2010.7,1244,14,5,3,10,8,3,2,1,1,1,0
Italy,1255,23,2017,2010.7,1232,15,7,4,20,3,5,2,0,2,2,0
Spain,1242,33,2017,2010.7,1209,16,5,5,17,16,4,4,0,0,1,1
Belgium,1228,27,2017,2010.7,1201,17,6,3,20,7,4,2,0,0,2,1
Scotland,1217,12,2017,2010.7,1205,18,6,2,7,5,3,1,1,0,2,1
Uruguay,1206,10,2017,2010.7,1196,19,3,7,5,5,1,1,1,4,1,2
Norway,1137,13,2017,2010.7,1124,20,4,5,5,8,2,1,0,4,2,0
Russia,1089,18,2017,2010.7,1071,21,10,1,15,3,2,1,4,0,4,0
Switzerland,1071,16,2017,2010.7,1055,22,5,4,10,6,4,3,0,1,1,0
Zambia,979,15,2017,2010.7,964,23,6,6,10,5,2,3,2,1,2,2
Romania,973,11,2017,2010.7,962,24,6,3,9,2,4,0,1,2,1,1
China,953,18,2017,2010.7,935,25,7,5,11,7,3,1,3,2,1,2
Chile,952,17,2017,2010.7,935,26,7,9,10,7,3,2,2,4,2,3
Trinidad and Tobago,921,17,2017,2010.7,904,27,10,5,14,3,3,0,5,5,2,0
Portugal,919,35,2017,2010.7,884,28,10,5,24,11,6,5,1,0,3,0
Japan,916,19,2017,2010.7,897,29,8,4,16,3,4,1,2,2,2,1
Ghana,912,21,2017,2010.7,891,30,6,8,10,11,3,3,0,4,3,1
Egypt,901,15,2017,2010.7,886,31,10,4,13,2,9,0,1,1,0,3
Paraguay,891,9,2017,2010.7,882,32,3,6,3,6,1,2,2,4,0,0
Costa Rica,882,14,2017,2010.7,868,33,6,10,6,8,2,3,0,6,4,1
Saudi Arabia,882,22,2017,2010.7,860,34,5,8,7,15,3,3,2,4,0,1
Bulgaria,862,9,2017,2010.7,853,35,4,3,6,3,3,0,1,2,0,1
USA,859,33,2017,2010.7,826,36,13,5,28,5,9,0,1,1,3,4
Ivory Coast,855,17,2017,2010.7,838,37,9,5,12,5,2,2,3,2,4,1
Thailand,837,7,2017,2010.7,830,38,4,4,3,4,1,1,2,3,1,0
Finland,811,11,2017,2010.7,800,39,5,4,8,3,2,1,1,1,2,2
Iraq,784,17,2017,2010.7,767,40,10,4,13,4,5,2,0,1,5,1
Indonesia,775,12,2017,2010.7,763,41,7,1,10,2,3,1,2,0,2,0
Nigeria,771,14,2017,2010.7,757,42,5,3,9,5,3,1,1,1,1,1
Iran,766,14,2017,2010.7,752,43,7,4,10,4,5,2,1,0,1,2
Wales,764,6,2017,2010.7,758,44,3,5,2,4,1,2,1,1,1,2
Australia,763,18,2017,2010.7,745,45,7,6,14,4,5,0,2,1,0,5
Tunisia,756,16,2017,2010.7,740,46,5,7,4,12,2,3,2,3,1,1
Kuwait,750,1,2017,2010.7,749,47,3,1,1,0,0,0,2,0,1,1
Ireland,739,10,2017,2010.7,729,48,7,4,7,3,2,1,3,1,2,2
Uganda,731,13,2017,2010.7,718,49,5,12,7,6,2,2,0,5,3,5
Malaysia,729,3,2017,2010.7,726,50,3,3,3,0,0,0,2,2,1,1
Honduras,706,21,2017,2010.7,685,51,7,12,9,12,3,3,1,5,3,4
Cameroon,691,20,2017,2010.7,671,52,11,8,13,7,5,2,3,2,3,4
Morocco,682,22,2017,2010.7,660,53,8,6,17,5,6,2,2,3,0,1
Kenya,680,11,2017,2010.7,669,54,7,4,8,3,4,0,0,3,3,1
Peru,659,12,2017,2010.7,647,55,5,4,8,4,4,1,0,0,1,3
Turkey,655,10,2017,2010.7,645,56,5,4,8,2,3,0,2,2,0,2
United Arab Emirates,643,9,2017,2010.7,634,57,5,5,7,2,3,1,1,2,1,2
Qatar,638,22,2017,2010.7,616,58,13,4,19,3,4,1,6,3,3,0
Algeria,637,24,2017,2010.7,613,59,9,3,21,3,6,0,2,2,1,1
Senegal,634,25,2017,2010.7,609,60,8,8,11,14,4,5,0,0,4,3
Northern Ireland,633,10,2017,2010.7,623,61,5,4,6,4,3,2,2,1,0,1
Colombia,626,17,2017,2010.7,609,62,3,8,3,14,1,3,1,2,1,3
Democratic Republic of the Congo,625,21,2017,2010.7,604,63,6,6,12,9,4,2,1,3,1,1
Malawi,622,4,2017,2010.7,618,64,5,2,3,1,2,0,0,1,3,1
Singapore,622,6,2017,2010.7,616,65,6,4,3,3,0,0,4,3,2,1
Greece,611,9,2017,2010.7,602,66,4,3,5,4,1,1,1,1,2,1
Jamaica,608,12,2017,2010.7,596,67,3,7,4,8,1,3,1,3,1,1
Guinea,599,13,2017,2010.7,586,68,3,5,6,7,1,2,1,3,1,0
Mali,588,4,2017,2010.7,584,69,4,5,2,2,1,0,0,3,3,2
Ecuador,577,13,2017,2010.7,564,70,6,4,8,5,2,1,3,3,1,0
Zimbabwe,547,28,2017,2010.7,519,71,5,8,11,17,2,4,1,2,2,2
Oman,545,33,2017,2010.7,512,72,5,5,22,11,3,4,1,1,1,0
El Salvador,522,13,2017,2010.7,509,73,7,4,10,3,4,0,2,2,1,2
Israel,521,3,2017,2010.7,518,74,4,3,1,2,0,1,3,2,1,0
Syria,519,16,2017,2010.7,503,75,4,8,7,9,2,1,0,2,2,5
Bahrain,518,17,2017,2010.7,501,76,7,6,7,10,1,4,1,1,5,1
Myanmar,485,15,2017,2010.7,470,77,4,4,4,11,1,3,2,0,1,1
Iceland,476,11,2017,2010.7,465,78,4,6,4,7,2,3,2,2,0,1
New Zealand,472,14,2017,2010.7,458,79,4,8,8,6,2,1,1,6,1,1
Croatia,466,12,2017,2010.7,454,80,3,8,6,6,2,2,0,3,1,3
Tanzania,463,14,2017,2010.7,449,81,7,7,9,5,3,1,0,3,4,3
India,456,18,2017,2010.7,438,82,6,3,12,6,4,3,0,0,2,0
Estonia,446,19,2017,2010.7,427,83,3,9,4,15,2,5,1,1,0,3
Latvia,446,6,2017,2010.7,440,84,4,4,5,1,1,0,3,3,0,1
Congo,432,7,2017,2010.7,425,85,4,4,3,4,0,0,2,3,2,1
Panama,430,22,2017,2010.7,408,86,7,9,14,8,5,1,0,5,2,3
Bolivia,429,10,2017,2010.7,419,87,4,4,6,4,3,1,0,3,1,0
South Africa,424,15,2017,2010.7,409,88,9,3,11,4,4,1,4,2,1,0
Hong Kong,420,8,2017,2010.7,412,89,5,4,6,2,2,0,2,2,1,2
Jordan,420,21,2017,2010.7,399,90,5,6,17,4,4,1,0,1,1,4
Martinique,417,10,2017,2010.7,407,91,3,4,7,3,2,0,1,3,0,1
Sudan,414,2,2017,2010.7,412,92,1,1,1,1,0,0,1,1,0,0
Ethiopia,410,5,2017,2010.7,405,93,2,4,1,4,0,1,0,2,2,1
Burkina Faso,403,23,2017,2010.7,380,94,9,7,17,6,5,1,0,3,4,3
Uzbekistan,390,5,2017,2010.7,385,95,4,4,5,0,2,0,0,4,2,0
Togo,385,12,2017,2010.7,373,96,3,9,9,3,2,1,1,6,0,2
Gabon,377,7,2017,2010.7,370,97,7,5,2,5,0,1,1,3,6,1
Serbia,375,13,2017,2010.7,362,98,3,6,5,8,2,3,0,1,1,2
Curaçao,373,8,2017,2010.7,365,99,4,5,1,7,0,3,2,2,2,0
Angola,370,2,2017,2010.7,368,100,1,5,0,2,0,1,0,2,1,2
Slovakia,368,12,2017,2010.7,356,101,3,5,5,7,3,2,0,3,0,0
Libya,362,11,2017,2010.7,351,102,6,7,8,3,2,0,2,3,2,4
Canada,350,11,2017,2010.7,339,103,3,5,4,7,2,1,0,2,1,2
Suriname,337,4,2017,2010.7,333,104,1,1,2,2,0,1,1,0,0,0
Lithuania,335,2,2017,2010.7,333,105,3,4,1,1,0,0,3,3,0,1
Ukraine,330,6,2017,2010.7,324,106,3,4,4,2,2,1,1,3,0,0
Venezuela,312,7,2017,2010.7,305,107,3,6,2,5,0,1,0,2,3,3
New Caledonia,310,5,2017,2010.7,305,108,2,1,3,2,1,0,0,0,1,1
Vietnam,297,9,2017,2010.7,288,109,4,2,6,3,1,1,0,0,3,1
Mozambique,287,8,2017,2010.7,279,110,5,2,5,3,2,2,2,0,1,0
Cyprus,286,8,2017,2010.7,278,111,3,6,4,4,1,1,1,5,1,0
Lebanon,278,6,2017,2010.7,272,112,1,3,2,4,1,3,0,0,0,0
Slovenia,272,8,2017,2010.7,264,113,3,3,8,0,2,0,0,3,1,0
Guadeloupe,270,3,2017,2010.7,267,114,1,1,2,1,0,0,0,1,1,0
Belarus,262,8,2017,2010.7,254,115,4,7,4,4,2,0,2,6,0,1
Fiji,262,18,2017,2010.7,244,116,7,5,16,2,3,0,2,2,2,3
Albania,255,10,2017,2010.7,245,117,2,6,2,8,1,2,1,3,0,1
Grenada,245,4,2017,2010.7,241,118,4,2,2,2,1,0,3,1,0,1
Georgia,241,18,2017,2010.7,223,119,7,5,13,5,3,0,2,2,2,3
Macedonia,230,16,2017,2010.7,214,120,6,3,11,5,3,2,1,0,2,1
Benin,222,11,2017,2010.7,211,121,4,6,5,6,2,1,0,1,2,4
Barbados,221,10,2017,2010.7,211,122,2,5,3,7,1,2,0,3,1,0
Rwanda,215,5,2017,2010.7,210,123,3,2,4,1,2,0,0,2,1,0
Palestine,214,28,2017,2010.7,186,124,3,4,20,8,3,4,0,0,0,0
Malta,212,3,2017,2010.7,209,125,5,3,3,0,1,0,3,3,1,0
Solomon Islands,211,25,2017,2010.7,186,126,4,6,11,14,2,2,0,3,2,1
St. Kitts and Nevis,210,5,2017,2010.7,205,127,2,4,3,2,2,0,0,2,0,2
Mauritius,206,5,2017,2010.7,201,128,3,6,2,3,0,0,1,4,2,2
Namibia,205,4,2017,2010.7,201,129,3,2,4,0,2,0,0,2,1,0
Madagascar,199,14,2017,2010.7,185,130,2,5,5,9,2,3,0,0,0,2
Tajikistan,193,10,2017,2010.7,183,131,3,3,6,4,1,1,1,1,1,1
Yemen,193,5,2017,2010.7,188,132,4,5,3,2,1,0,2,2,1,3
Maldives,190,5,2017,2010.7,185,133,2,4,1,4,0,1,2,3,0,0
Philippines,190,15,2017,2010.7,175,134,3,6,6,9,1,2,0,2,2,2
Botswana,186,1,2017,2010.7,185,135,1,4,1,0,0,0,1,3,0,1
Turkmenistan,185,7,2017,2010.7,178,136,3,2,5,2,2,0,1,1,0,1
Cambodia,183,7,2017,2010.7,176,137,7,2,7,0,1,0,6,2,0,0
Armenia,182,18,2017,2010.7,164,138,6,3,16,2,4,0,2,2,0,1
Guyana,180,2,2017,2010.7,178,139,1,3,0,2,0,0,0,2,1,1
Luxembourg,179,7,2017,2010.7,172,140,6,3,7,0,3,0,2,2,1,1
Lesotho,175,6,2017,2010.7,169,141,2,5,4,2,1,0,1,1,0,4
Kazakhstan,173,4,2017,2010.7,169,142,3,4,2,2,0,0,2,4,1,0
Moldova,172,7,2017,2010.7,165,143,3,7,2,5,0,1,2,4,1,2
Burundi,167,17,2017,2010.7,150,144,5,4,16,1,4,0,1,2,0,2
Swaziland,167,1,2017,2010.7,166,145,1,2,1,0,0,0,1,1,0,1
Niger,165,2,2017,2010.7,163,146,2,1,0,2,0,1,1,0,1,0
Bermuda,155,6,2017,2010.7,149,147,2,1,4,2,0,1,2,0,0,0
St. Lucia,151,1,2017,2010.7,150,148,1,1,0,1,0,0,0,0,1,1
Azerbaijan,150,10,2017,2010.7,140,149,4,3,7,3,1,1,3,2,0,0
Gambia,149,3,2017,2010.7,146,150,1,3,0,3,0,2,0,1,1,0
Papua New Guinea,146,3,2017,2010.7,143,151,1,1,1,2,0,0,1,1,0,0
Cape Verde,143,6,2017,2010.7,137,152,3,3,2,4,1,2,2,1,0,0
Dominica,141,4,2017,2010.7,137,153,1,2,2,2,1,0,0,0,0,2
Faroe Islands,129,2,2017,2010.7,127,154,3,3,1,1,1,0,1,2,1,1
Laos,126,2,2017,2010.7,124,155,1,4,1,1,0,0,1,4,0,0
Nepal,126,2,2017,2010.7,124,156,3,3,1,1,0,0,1,3,2,0
Kyrgyzstan,113,15,2017,2010.7,98,157,2,5,4,11,2,3,0,1,0,1
Guinea-Bissau,110,4,2017,2010.7,106,158,3,4,1,3,1,0,2,2,0,2
Montenegro,108,12,2017,2010.7,96,159,5,2,7,5,2,1,3,1,0,0
Mauritania,106,5,2017,2010.7,101,160,4,5,3,2,2,0,2,4,0,1
Afghanistan,98,9,2017,2010.7,89,161,4,4,8,1,2,0,0,3,2,1
Dominican Republic,96,4,2017,2010.7,92,162,1,1,1,3,1,1,0,0,0,0
Nicaragua,86,7,2017,2010.7,79,163,3,9,3,4,1,0,2,8,0,1
Macau,85,7,2017,2010.7,78,164,4,2,6,1,1,0,3,2,0,0
Equatorial Guinea,82,4,2017,2010.7,78,165,2,1,4,0,1,0,1,1,0,0
Liechtenstein,73,3,2017,2010.7,70,166,3,5,0,3,0,1,3,3,0,1
Central African Republic,67,3,2017,2010.7,64,167,2,1,3,0,1,0,1,1,0,0
Seychelles,61,2,2017,2010.7,59,168,1,3,1,1,0,0,1,3,0,0
Belize,46,2,2017,2010.7,44,169,2,2,0,2,0,0,2,2,0,0
Tonga,41,3,2017,2010.7,38,170,1,3,0,3,0,0,1,3,0,0
Andorra,36,1,2017,2010.7,35,171,4,3,1,0,1,0,2,3,1,0
Bhutan,36,2,2017,2010.7,34,172,3,2,2,0,0,0,3,2,0,0
Djibouti,30,2,2017,2010.7,28,173,1,3,2,0,1,0,0,3,0,0
Brunei,25,0,2017,2010.7,25,174,1,1,0,0,0,0,1,1,0,0
Taiwan,23,15,2017,2010.7,8,175,4,4,11,4,4,1,0,2,0,1
Gibraltar,21,1,2017,2010.7,20,176,2,2,1,0,0,0,2,2,0,0
São Tomé and Príncipe,21,2,2017,2010.7,19,177,1,1,0,2,0,0,1,1,0,0
Comoros,20,5,2017,2010.7,15,178,2,4,3,2,1,1,0,2,1,1
San Marino,20,1,2017,2010.7,19,179,4,4,0,1,0,0,4,4,0,0
South Sudan,18,7,2017,2010.7,11,180,3,3,6,1,1,0,1,3,1,0
Tuvalu,18,4,2017,2010.7,14,181,1,3,4,0,1,0,0,3,0,0
Germany,2511,6,2018,2010.8,2505,1,5,2,5,1,2,0,2,2,1,0
Sweden,1954,9,2018,2010.8,1945,2,6,5,3,6,2,2,2,2,2,1
Brazil,1886,17,2018,2010.8,1869,3,4,5,6,11,2,5,1,0,1,0
Hungary,1782,4,2018,2010.8,1778,4,3,1,3,1,0,0,3,0,0,1
England,1738,17,2018,2010.8,1721,5,5,4,11,6,3,3,1,0,1,1
Argentina,1688,13,2018,2010.8,1675,6,3,4,5,8,1,2,1,2,1,0
Netherlands,1505,5,2018,2010.8,1500,7,1,3,0,5,0,1,1,0,0,2
South Korea,1395,12,2018,2010.8,1383,8,5,6,5,7,2,2,2,3,1,1
France,1379,21,2018,2010.8,1358,9,8,3,16,5,6,2,1,0,1,1
Denmark,1351,6,2018,2010.8,1345,10,6,3,4,2,2,1,1,0,3,2
Mexico,1336,7,2018,2010.8,1329,11,5,4,4,3,2,2,2,2,1,0
Austria,1309,10,2018,2010.8,1299,12,4,1,6,4,3,1,1,0,0,0
Czech Republic,1298,5,2018,2010.8,1293,13,2,2,1,4,1,1,1,1,0,0
Poland,1273,11,2018,2010.8,1262,14,6,1,10,1,2,1,3,0,1,0
Italy,1260,5,2018,2010.8,1255,15,3,2,3,2,1,0,1,1,1,1
Spain,1258,16,2018,2010.8,1242,16,3,5,9,7,1,2,0,0,2,3
Belgium,1253,25,2018,2010.8,1228,17,7,3,22,3,6,2,0,1,1,0
Uruguay,1219,13,2018,2010.8,1206,18,5,3,8,5,4,3,1,0,0,0
Scotland,1218,1,2018,2010.8,1217,19,1,3,0,1,0,1,1,2,0,0
Norway,1146,9,2018,2010.8,1137,20,2,2,5,4,2,2,0,0,0,0
Russia,1102,13,2018,2010.8,1089,21,8,1,13,0,2,0,3,1,3,0
Switzerland,1086,15,2018,2010.8,1071,22,3,5,10,5,2,2,0,1,1,2
Romania,981,8,2018,2010.8,973,23,3,1,6,2,3,1,0,0,0,0
China,957,4,2018,2010.8,953,24,3,1,2,2,1,1,2,0,0,0
Portugal,932,13,2018,2010.8,919,25,6,3,11,2,3,0,1,1,2,2
Japan,928,12,2018,2010.8,916,26,5,4,7,5,1,1,2,3,2,0
Trinidad and Tobago,922,1,2018,2010.8,921,27,1,2,0,1,0,1,1,0,0,1
Egypt,905,4,2018,2010.8,901,28,1,7,0,4,0,0,1,5,0,2
Saudi Arabia,895,13,2018,2010.8,882,29,4,8,7,6,3,1,1,6,0,1
Costa Rica,889,7,2018,2010.8,882,30,2,6,3,4,1,1,1,4,0,1
USA,865,6,2018,2010.8,859,31,2,2,4,2,2,0,0,1,0,1
Ivory Coast,859,4,2018,2010.8,855,32,1,1,2,2,0,1,0,0,1,0
Finland,820,9,2018,2010.8,811,33,3,2,7,2,2,1,0,1,1,0
Iran,777,11,2018,2010.8,766,34,4,5,6,5,2,3,1,2,1,0
Nigeria,777,6,2018,2010.8,771,35,3,5,4,2,1,1,1,4,1,0
Australia,772,9,2018,2010.8,763,36,2,5,0,9,0,2,1,2,1,1
Wales,770,6,2018,2010.8,764,37,1,2,0,6,0,1,1,0,0,1
Tunisia,767,11,2018,2010.8,756,38,4,4,3,8,2,1,2,1,0,2
Kuwait,754,4,2018,2010.8,750,39,3,1,4,0,1,0,1,1,1,0
Ireland,741,2,2018,2010.8,739,40,1,2,2,0,1,0,0,2,0,0
Malaysia,740,11,2018,2010.8,729,41,3,1,10,1,2,0,0,1,1,0
Uganda,735,4,2018,2010.8,731,42,2,2,3,1,1,0,0,2,1,0
Cameroon,694,3,2018,2010.8,691,43,1,1,0,3,0,1,1,0,0,0
Morocco,693,11,2018,2010.8,682,44,2,6,2,9,1,3,1,1,0,2
Kenya,691,11,2018,2010.8,680,45,3,4,3,8,2,1,1,2,0,1
Peru,671,12,2018,2010.8,659,46,4,4,7,5,3,2,1,1,0,1
Turkey,663,8,2018,2010.8,655,47,3,2,5,3,2,0,0,0,1,2
Algeria,644,7,2018,2010.8,637,48,4,1,7,0,1,0,3,1,0,0
Qatar,643,5,2018,2010.8,638,49,1,1,2,3,0,1,0,0,1,0
Senegal,642,8,2018,2010.8,634,50,2,5,1,7,0,2,1,1,1,2
Colombia,635,9,2018,2010.8,626,51,3,4,2,7,0,3,1,0,2,1
Northern Ireland,635,2,2018,2010.8,633,52,1,2,2,0,1,0,0,1,0,1
Singapore,625,3,2018,2010.8,622,53,1,1,3,0,1,0,0,1,0,0
Malawi,623,1,2018,2010.8,622,54,2,2,1,0,0,0,1,0,1,2
Jamaica,616,8,2018,2010.8,608,55,2,2,3,5,0,2,0,0,2,0
Greece,612,1,2018,2010.8,611,56,2,1,1,0,1,0,1,1,0,0
Zimbabwe,552,5,2018,2010.8,547,57,2,3,1,4,0,0,1,0,1,3
Bahrain,522,4,2018,2010.8,518,58,2,1,4,0,1,0,0,1,1,0
Iceland,493,17,2018,2010.8,476,59,3,6,5,12,0,2,2,3,1,1
Myanmar,487,2,2018,2010.8,485,60,1,2,1,1,1,0,0,2,0,0
Croatia,479,13,2018,2010.8,466,61,4,5,5,8,2,3,1,1,1,1
India,466,10,2018,2010.8,456,62,3,1,9,1,2,0,1,1,0,0
Tanzania,466,3,2018,2010.8,463,63,1,1,2,1,1,0,0,1,0,0
Estonia,450,4,2018,2010.8,446,64,3,3,4,0,1,0,1,2,1,1
Latvia,450,4,2018,2010.8,446,65,3,3,2,2,1,0,2,1,0,2
Panama,433,3,2018,2010.8,430,66,2,6,1,2,0,1,1,5,1,0
South Africa,431,7,2018,2010.8,424,67,3,1,5,2,1,1,0,0,2,0
Burkina Faso,406,3,2018,2010.8,403,68,1,1,2,1,1,1,0,0,0,0
Serbia,385,10,2018,2010.8,375,69,6,1,9,1,2,1,4,0,0,0
Angola,375,5,2018,2010.8,370,70,4,1,4,1,1,0,1,0,2,1
Slovakia,375,7,2018,2010.8,368,71,3,1,4,3,1,1,1,0,1,0
Lithuania,337,2,2018,2010.8,335,72,2,4,1,1,0,1,1,3,1,0
Ukraine,337,7,2018,2010.8,330,73,3,1,3,4,1,1,0,0,2,0
Mozambique,293,6,2018,2010.8,287,74,1,2,2,4,1,1,0,1,0,0
Cyprus,286,0,2018,2010.8,286,75,1,1,0,0,0,0,0,1,1,0
Slovenia,274,2,2018,2010.8,272,76,1,2,0,2,0,1,1,1,0,0
Belarus,266,4,2018,2010.8,262,77,1,3,1,3,0,2,0,1,1,0
Georgia,248,7,2018,2010.8,241,78,2,2,6,1,2,1,0,1,0,0
Malta,213,1,2018,2010.8,212,79,2,2,0,1,0,0,2,1,0,1
Antigua and Barbuda,212,4,2018,2010.8,208,80,2,1,3,1,1,0,1,0,0,1
St. Kitts and Nevis,212,2,2018,2010.8,210,81,1,1,1,1,0,0,1,1,0,0
Namibia,208,3,2018,2010.8,205,82,1,2,2,1,1,0,0,1,0,1
Madagascar,203,4,2018,2010.8,199,83,3,3,3,1,1,1,0,1,2,1
Botswana,200,14,2018,2010.8,186,84,2,5,7,7,2,3,0,0,0,2
Maldives,199,9,2018,2010.8,190,85,1,1,7,2,1,0,0,1,0,0
Luxembourg,181,2,2018,2010.8,179,86,3,1,1,1,1,1,1,0,1,0
Kazakhstan,180,7,2018,2010.8,173,87,1,2,3,4,1,1,0,1,0,0
Lesotho,177,2,2018,2010.8,175,88,2,2,1,1,1,0,0,2,1,0
Moldova,173,1,2018,2010.8,172,89,2,3,1,0,0,0,2,1,0,2
Swaziland,168,1,2018,2010.8,167,90,1,3,0,1,0,1,1,1,0,1
Azerbaijan,157,7,2018,2010.8,150,91,4,2,4,3,1,1,1,1,2,0
Kyrgyzstan,120,7,2018,2010.8,113,92,2,1,7,0,2,0,0,1,0,0
Montenegro,110,2,2018,2010.8,108,93,2,1,2,0,0,0,1,0,1,1
Macau,85,0,2018,2010.8,85,94,1,1,0,0,0,0,1,1,0,0
Central African Republic,75,8,2018,2010.8,67,95,2,2,4,4,2,0,0,0,0,2
Seychelles,64,3,2018,2010.8,61,96,1,3,0,3,0,0,0,1,1,2
Mongolia,52,2,2018,2010.8,50,97,1,1,0,2,0,0,1,0,0,1
Belize,50,4,2018,2010.8,46,98,1,1,4,0,1,0,0,0,0,1
Taiwan,24,1,2018,2010.8,23,99,3,1,1,0,1,0,2,1,0,0
